Vendor	Supplier	Category
.strandberg	Diffusion Audio	"Guitars, Basses & Accessories"
ABM-Mueller	Allparts	"Guitars, Basses & Accessories"
Accent	Saga Musical	"Guitars, Basses & Accessories"
Ace	Audionova	"Guitars, Basses & Accessories"
Airline	Eastwood Guitars	"Guitars, Basses & Accessories"
Alhambra	Counterpoint	"Guitars, Basses & Accessories"
Allen Cast Tailpieces	Allen Guitars	"Guitars, Basses & Accessories"
Allen Custom Guitars	Allen Guitars	"Guitars, Basses & Accessories"
Allen Slotted Fretboards	Allen Guitars	"Guitars, Basses & Accessories"
Allparts	Allparts	"Guitars, Basses & Accessories"
Alpha Potentiometers	Next Gen Musical	"Guitars, Basses & Accessories"
Alvarez	SFM	"Guitars, Basses & Accessories"
Applause	B&J Music	"Guitars, Basses & Accessories"
Aria	Kana Music	"Guitars, Basses & Accessories"
Aria Pro II	Kana Music	"Guitars, Basses & Accessories"
Art & Lutherie	Godin	"Guitars, Basses & Accessories"
Artec	Kana Music	"Guitars, Basses & Accessories"
Artist	BRTB	"Guitars, Basses & Accessories"
Aspri	Aspri Creative	"Guitars, Basses & Accessories"
Augustine Strings	Hal Leonard	"Guitars, Basses & Accessories"
Austin	St. Louis Music	"Guitars, Basses & Accessories"
Avante by Veillette	Veillette	"Guitars, Basses & Accessories"
Avenir Guitars	Stonebridge	"Guitars, Basses & Accessories"
Avian	Avian Guitars	"Guitars, Basses & Accessories"
AxLabs Guitar Hardware	AP International	"Guitars, Basses & Accessories"
B.C. Rich	B.C. Rich	"Guitars, Basses & Accessories"
B&G Crossroads	Eastwood Guitars	"Guitars, Basses & Accessories"
Backlund	Eastwood Guitars	"Guitars, Basses & Accessories"
Bartolini	Kana Music	"Guitars, Basses & Accessories"
BeaverCreek	D'Addario Canada	"Guitars, Basses & Accessories"
Bedell	Two Old Hippies	"Guitars, Basses & Accessories"
Benedetto	Benedetto Guitars	"Guitars, Basses & Accessories"
Bill Edwards Guitars	Bill Edwards	"Guitars, Basses & Accessories"
Bill Edwards Locking Nuts	Bill Edwards	"Guitars, Basses & Accessories"
Bill Edwards Necks	Bill Edwards	"Guitars, Basses & Accessories"
Bill Edwards Tremolos	Bill Edwards	"Guitars, Basses & Accessories"
Black Diamond	"Black Diamond Strings, Golden Hawk"	"Guitars, Basses & Accessories"
Blueridge Guitars	Saga Musical	"Guitars, Basses & Accessories"
Bourgeois Guitars	Eastman Music	"Guitars, Basses & Accessories"
Breedlove	Two Old Hippies	"Guitars, Basses & Accessories"
Bridgeport Guitars	Stonebridge	"Guitars, Basses & Accessories"
Bristol	Saga Musical	"Guitars, Basses & Accessories"
BSX Basses	BSX Bass	"Guitars, Basses & Accessories"
Bullet Cables	Audionova	"Guitars, Basses & Accessories"
C.F. Martin	C.F. Martin	"Guitars, Basses & Accessories"
Charvel	Fender	"Guitars, Basses & Accessories"
ChickenPicks	Blaze Music	"Guitars, Basses & Accessories"
Classic	Empire Music	"Guitars, Basses & Accessories"
Clayton Picks	Blaze Music	"Guitars, Basses & Accessories"
CMC	Chesbro Music	"Guitars, Basses & Accessories"
Cole Clark	Korg USA	"Guitars, Basses & Accessories"
Conklin Custom Shop	Conklin Guitars	"Guitars, Basses & Accessories"
Cordoba	Cordoba Music	"Guitars, Basses & Accessories"
Cort	Coast Music	"Guitars, Basses & Accessories"
CruzTools	Yorkville Sound	"Guitars, Basses & Accessories"
D'Addario	D'Addario Canada	"Guitars, Basses & Accessories"
D'Andrea	Audionova	"Guitars, Basses & Accessories"
D'Angelico	B&J Music	"Guitars, Basses & Accessories"
Dava	D'Addario Canada	"Guitars, Basses & Accessories"
Dean Guitars	Armadillo Enterprises	"Guitars, Basses & Accessories"
Dean Markley	Launch Music	"Guitars, Basses & Accessories"
DeArmond	Cordoba Music	"Guitars, Basses & Accessories"
DeMars Guitars	DeMars Guitars	"Guitars, Basses & Accessories"
Denver Guitars	Yorkville Sound	"Guitars, Basses & Accessories"
Diamond Guitars	Diamond Guitars	"Guitars, Basses & Accessories"
DiMarzio	Blaze Music	"Guitars, Basses & Accessories"
Dingwall Basses	"Blaze Music, Dingwall"	"Guitars, Basses & Accessories"
Dion Guitars	Dion Guitars	"Guitars, Basses & Accessories"
Ditson	Coast Music	"Guitars, Basses & Accessories"
DMI Guitar Labs	AP International	"Guitars, Basses & Accessories"
Don't Fret Enterprises	Counterpoint	"Guitars, Basses & Accessories"
Donner	Donner	"Guitars, Basses & Accessories"
Dowina	5th Crown	"Guitars, Basses & Accessories"
DR	B&J Music	"Guitars, Basses & Accessories"
Dragonfly	Dragonfly	"Guitars, Basses & Accessories"
Duesenberg	SFM	"Guitars, Basses & Accessories"
Dunlop	Coast Music	"Guitars, Basses & Accessories"
DVT	Sherlock Audio	"Guitars, Basses & Accessories"
EKO	Harris Musical	"Guitars, Basses & Accessories"
Eko Guitars	Kelley Distribution	"Guitars, Basses & Accessories"
Electroswitch	Next Gen Musical	"Guitars, Basses & Accessories"
Elixir	Coast Music	"Guitars, Basses & Accessories"
Elrick	Elrick Bass	"Guitars, Basses & Accessories"
EMG Pickups	EMG Pickups	"Guitars, Basses & Accessories"
Encore	JHS	"Guitars, Basses & Accessories"
Epiphone	Yorkville Sound	"Guitars, Basses & Accessories"
Ernie Ball Strings & Accessories	Yorkville Sound	"Guitars, Basses & Accessories"
Ernie Ball Music Man	Ernie Ball	"Guitars, Basses & Accessories"
ESP Guitars	B&J Music	"Guitars, Basses & Accessories"
EVH	Fender	"Guitars, Basses & Accessories"
F Bass	F Bass	"Guitars, Basses & Accessories"
Famous #351	Harris Musical	"Guitars, Basses & Accessories"
Fender	Fender	"Guitars, Basses & Accessories"
Fiesta	Kana Music	"Guitars, Basses & Accessories"
Fishman	Fishman	"Guitars, Basses & Accessories"
Floyd Rose	Blaze Music	"Guitars, Basses & Accessories"
Framus	Framus & Warwick	"Guitars, Basses & Accessories"
Frank Brothers Guitars	Frank Brothers	"Guitars, Basses & Accessories"
Fret-King	5th Crown	"Guitars, Basses & Accessories"
Furch	Stonebridge	"Guitars, Basses & Accessories"
G&L	G&L	"Guitars, Basses & Accessories"
G7th	Coast Music	"Guitars, Basses & Accessories"
Gabbanelli Bajo Sexto	Gabbanelli	"Guitars, Basses & Accessories"
Gallien-Krueger	Yorkville Sound	"Guitars, Basses & Accessories"
Gavitt Wire	Next Gen Musical	"Guitars, Basses & Accessories"
GHS	Coast Music	"Guitars, Basses & Accessories"
Gibson	Yorkville Sound	"Guitars, Basses & Accessories"
Gitane Guitars	Saga Musical	"Guitars, Basses & Accessories"
Godin	Godin	"Guitars, Basses & Accessories"
Godin Acoustic Solutions	Godin	"Guitars, Basses & Accessories"
Gotoh	"Geo. Heinl, Next Gen Musical"	"Guitars, Basses & Accessories"
Graph Tech	Coast Music	"Guitars, Basses & Accessories"
Gravity Picks	"Ace Products, Golden Hawk"	"Guitars, Basses & Accessories"
Greasy Groove	Greasy Groove	"Guitars, Basses & Accessories"
Gretsch	B&J Music	"Guitars, Basses & Accessories"
Groove Guitars	Kana Music	"Guitars, Basses & Accessories"
GrooveTech	Yorkville Sound	"Guitars, Basses & Accessories"
Grover	Coast Music	"Guitars, Basses & Accessories"
Grover Tuning Keys	Allparts Music	"Guitars, Basses & Accessories"
Gruv Gear	Gruv Gear	"Guitars, Basses & Accessories"
GSM	GSM Guitar	"Guitars, Basses & Accessories"
Guild	Cordoba Music	"Guitars, Basses & Accessories"
Guitar Doctor	Wyres	"Guitars, Basses & Accessories"
Guitar Tech	JHS	"Guitars, Basses & Accessories"
Hagstrom	Erikson Music	"Guitars, Basses & Accessories"
Hall Guitar Slides	Hall Crystal Flutes	"Guitars, Basses & Accessories"
Hammertone	F Bass	"Guitars, Basses & Accessories"
Harmony	SFM	"Guitars, Basses & Accessories"
Herco	Coast Music	"Guitars, Basses & Accessories"
Heritage Guitars	SFM	"Guitars, Basses & Accessories"
HexHider	AP International	"Guitars, Basses & Accessories"
Highland Guitars	AudioOne Corp.	"Guitars, Basses & Accessories"
Hipshot	Next Gen Musical	"Guitars, Basses & Accessories"
H�fner	Adam Hall	"Guitars, Basses & Accessories"
Hooky Series	Eastwood Guitars	"Guitars, Basses & Accessories"
Ibanez	Hoshino USA	"Guitars, Basses & Accessories"
Indiana Guitars	Chesbro Music	"Guitars, Basses & Accessories"
Jackson	Fender	"Guitars, Basses & Accessories"
Jarrell	Jarrell Guitars	"Guitars, Basses & Accessories"
Jasmine	B&J Music	"Guitars, Basses & Accessories"
Jay Turser	Coast Music	"Guitars, Basses & Accessories"
John Pearse	Launch Music	"Guitars, Basses & Accessories"
JOI	JOI Guitars	"Guitars, Basses & Accessories"
JOYO Technologies	B&J Music	"Guitars, Basses & Accessories"
Kanile`a	Kanile`a	"Guitars, Basses & Accessories"
Ken Smith	Ken Smith	"Guitars, Basses & Accessories"
Kerly Music USA	Kana Music	"Guitars, Basses & Accessories"
Kinal	Kinal	"Guitars, Basses & Accessories"
Kluson	Yorkville Sound	"Guitars, Basses & Accessories"
Kramer Guitars	Yorkville Sound	"Guitars, Basses & Accessories"
KTS Titanium Hardware	AP International	"Guitars, Basses & Accessories"
Kwasnycia Guitars	Kwasnycia Guitars	"Guitars, Basses & Accessories"
Kyser	B&J Music	"Guitars, Basses & Accessories"
La Bella	Music 8	"Guitars, Basses & Accessories"
L�g	Coast Music	"Guitars, Basses & Accessories"
Larriv�e	Jean Larriv�e	"Guitars, Basses & Accessories"
Latch Lake	Latch Lake	"Guitars, Basses & Accessories"
Le Marquis	Kana Music	"Guitars, Basses & Accessories"
Loog	Hal Leonard	"Guitars, Basses & Accessories"
Loucin	Loucin	"Guitars, Basses & Accessories"
LR Baggs	Yorkville Sound	"Guitars, Basses & Accessories"
Luna Guitars	Armadillo Enterprises	"Guitars, Basses & Accessories"
Luxxtone	Blaze Music	"Guitars, Basses & Accessories"
Madera	Kana Music	"Guitars, Basses & Accessories"
Maestro Electronics	Yorkville Sound	"Guitars, Basses & Accessories"
Manuel Rodriquez	B&J Music	"Guitars, Basses & Accessories"
Michael Kelly Guitars	Hal Leonard	"Guitars, Basses & Accessories"
Morgan Guitars	Morgan Guitars	"Guitars, Basses & Accessories"
Morgan Monroe	Chesbro Music	"Guitars, Basses & Accessories"
Morifone	Morifone	"Guitars, Basses & Accessories"
MRG	Eastwood Guitars	"Guitars, Basses & Accessories"
MRG Studio	Eastwood Guitars	"Guitars, Basses & Accessories"
National Reso-Phonic Guitars	National Reso-Phonic	"Guitars, Basses & Accessories"
New Century Series.	Conklin Guitars	"Guitars, Basses & Accessories"
Next Gen Parts	Next Gen Musical	"Guitars, Basses & Accessories"
Norman	Godin	"Guitars, Basses & Accessories"
Olympia	Kana Music	"Guitars, Basses & Accessories"
Ortega Guitars	Meinl USA	"Guitars, Basses & Accessories"
Oscar Schmidt	Erikson Music	"Guitars, Basses & Accessories"
Ovation	B&J Music	"Guitars, Basses & Accessories"
Ozark Instruments	Counterpoint	"Guitars, Basses & Accessories"
Paige Capos	Blaze Music	"Guitars, Basses & Accessories"
Palermo	Palermo	"Guitars, Basses & Accessories"
Paul Reed Smith - PRS	Paul Reed Smith	"Guitars, Basses & Accessories"
Perfection Pegs	St. Louis Music	"Guitars, Basses & Accessories"
Picks by the Pound	Harris Musical	"Guitars, Basses & Accessories"
Pilgrim	JHS	"Guitars, Basses & Accessories"
Ping	B&J Music	"Guitars, Basses & Accessories"
Prestige Guitars	Prestige	"Guitars, Basses & Accessories"
Pure Tone Technologies	Blaze Music	"Guitars, Basses & Accessories"
Quilter Labs	SFM	"Guitars, Basses & Accessories"
RainSong	RainSong	"Guitars, Basses & Accessories"
Ray Ross Saddle-Less Bridge	AP International	"Guitars, Basses & Accessories"
Rayco	Rayco	"Guitars, Basses & Accessories"
Razor Pickups	Allparts	"Guitars, Basses & Accessories"
Regal	Saga Musical	"Guitars, Basses & Accessories"
Rickenbacker	Rickenbacker	"Guitars, Basses & Accessories"
Riversong	Riversong	"Guitars, Basses & Accessories"
Riversong Wooden Picks	Riversong	"Guitars, Basses & Accessories"
Rivolta	Eastwood Guitars	"Guitars, Basses & Accessories"
Rotosound	Yorkville Sound	"Guitars, Basses & Accessories"
Rowin	"Kana Music, Music 8"	"Guitars, Basses & Accessories"
Sadowsky	Framus & Warwick	"Guitars, Basses & Accessories"
Santa Cruz	Santa Cruz	"Guitars, Basses & Accessories"
Santos Martinez	JHS	"Guitars, Basses & Accessories"
Schaller	Coast Music	"Guitars, Basses & Accessories"
Schatten Design	Schatten Design	"Guitars, Basses & Accessories"
Schatten Pickups	Next Gen Musical	"Guitars, Basses & Accessories"
Schecter	Erikson Music	"Guitars, Basses & Accessories"
Scheerhorn Guitars	National Reso-Phonic	"Guitars, Basses & Accessories"
Seagull	Godin	"Guitars, Basses & Accessories"
Seymour Duncan	Erikson Music	"Guitars, Basses & Accessories"
Shadow	D'Addario Canada	"Guitars, Basses & Accessories"
Sheeran by Lowden	Launch Music	"Guitars, Basses & Accessories"
Shergold Guitars	5th Crown	"Guitars, Basses & Accessories"
Shubb	Coast Music	"Guitars, Basses & Accessories"
Sidejack	Eastwood Guitars	"Guitars, Basses & Accessories"
Sigma	Coast Music	"Guitars, Basses & Accessories"
Simon & Patrick	Godin	"Guitars, Basses & Accessories"
Sintoms	Allparts	"Guitars, Basses & Accessories"
Sire	Coast Music	"Guitars, Basses & Accessories"
SIT	Blaze Music	"Guitars, Basses & Accessories"
Smith Pro Polish	Ken Smith	"Guitars, Basses & Accessories"
SonoTone	SonoTone	"Guitars, Basses & Accessories"
Source Audio	Audio Distributors International	"Guitars, Basses & Accessories"
Spector	Korg USA	"Guitars, Basses & Accessories"
Sperzel	Sperzel	"Guitars, Basses & Accessories"
Spider Capo	Audionova	"Guitars, Basses & Accessories"
Squier	Fender	"Guitars, Basses & Accessories"
Steinberger	Yorkville Sound	"Guitars, Basses & Accessories"
Stone Tone Products	AP International	"Guitars, Basses & Accessories"
Stonebridge	Stonebridge	"Guitars, Basses & Accessories"
Takamine	B&J Music	"Guitars, Basses & Accessories"
Tanara Guitars	Chesbro Music	"Guitars, Basses & Accessories"
Taylor	Taylor Guitars	"Guitars, Basses & Accessories"
Teton	Chesbro Music	"Guitars, Basses & Accessories"
The Bill Edwards Fretboard	Bill Edwards	"Guitars, Basses & Accessories"
The Music Link	Blaze Music	"Guitars, Basses & Accessories"
The Original Cat Tongue Picks	Yorkville Sound	"Guitars, Basses & Accessories"
The Rock Slide	Yorkville Sound	"Guitars, Basses & Accessories"
Timber Tones	Harris Musical	"Guitars, Basses & Accessories"
Timeless Instruments	Timeless Instruments	"Guitars, Basses & Accessories"
Toby Basses	Yorkville Sound	"Guitars, Basses & Accessories"
Tone	Kana Music	"Guitars, Basses & Accessories"
TonePros	Blaze Music	"Guitars, Basses & Accessories"
ToneWoodAmp	HONZ	"Guitars, Basses & Accessories"
Towner	Next Gen Musical	"Guitars, Basses & Accessories"
Traveler	Traveler Guitars	"Guitars, Basses & Accessories"
Tribute by G&L	G&L	"Guitars, Basses & Accessories"
Tune Tech	Chesbro Music	"Guitars, Basses & Accessories"
US Blues	Harris Musical	"Guitars, Basses & Accessories"
VALCO	Eastwood Guitars	"Guitars, Basses & Accessories"
Valencia	Coast Music	"Guitars, Basses & Accessories"
Vega-Trem	Audionova	"Guitars, Basses & Accessories"
Veillette	Veillette	"Guitars, Basses & Accessories"
Vimex	Next Gen Musical	"Guitars, Basses & Accessories"
Vintage	5th Crown	"Guitars, Basses & Accessories"
Walden	Coast Music	"Guitars, Basses & Accessories"
Warren Ellis	Eastwood Guitars	"Guitars, Basses & Accessories"
Warwick	Framus & Warwick	"Guitars, Basses & Accessories"
Washburn	Erikson Music	"Guitars, Basses & Accessories"
WD Music	Yorkville Sound	"Guitars, Basses & Accessories"
WD Pickguards	Yorkville Sound	"Guitars, Basses & Accessories"
Wyres	Wyres	"Guitars, Basses & Accessories"
Zer0 Glide	Yorkville Sound	"Guitars, Basses & Accessories"
Zion	Zion Guitar	"Guitars, Basses & Accessories"
Aguilar	Korg USA	"Instrument Amplifiers, Pedals & Accessories"
Alexander Pedals	Search & Distro	"Instrument Amplifiers, Pedals & Accessories"
Ashdown	Yorkville Sound	"Instrument Amplifiers, Pedals & Accessories"
Baroni Lab	Search & Distro	"Instrument Amplifiers, Pedals & Accessories"
BBE	BBE Sound	"Instrument Amplifiers, Pedals & Accessories"
Beetronics	Search & Distro	"Instrument Amplifiers, Pedals & Accessories"
Belcat	Harris Musical	"Instrument Amplifiers, Pedals & Accessories"
Benson Amps	Search & Distro	"Instrument Amplifiers, Pedals & Accessories"
Big Tone Music Brewery	Search & Distro	"Instrument Amplifiers, Pedals & Accessories"
Blackstar	Korg USA	"Instrument Amplifiers, Pedals & Accessories"
BOSS	Roland Canada	"Instrument Amplifiers, Pedals & Accessories"
Budda Amplification	Peavey	"Instrument Amplifiers, Pedals & Accessories"
Caroline Guitar Company	Search & Distro	"Instrument Amplifiers, Pedals & Accessories"
Celestion	"McBride, Q-Components"	"Instrument Amplifiers, Pedals & Accessories"
Chase Bliss Audio	Chase Bliss Audio	"Instrument Amplifiers, Pedals & Accessories"
Cicognani Engineering	Godlyke	"Instrument Amplifiers, Pedals & Accessories"
Composite Acoustics	Peavey	"Instrument Amplifiers, Pedals & Accessories"
CopperSound	CopperSound	"Instrument Amplifiers, Pedals & Accessories"
Cusack Music	Search & Distro	"Instrument Amplifiers, Pedals & Accessories"
Damnation Audio	Search & Distro	"Instrument Amplifiers, Pedals & Accessories"
Danelectro	D'Addario Canada	"Instrument Amplifiers, Pedals & Accessories"
Darkglass	Korg USA	"Instrument Amplifiers, Pedals & Accessories"
DC Voltage	Blaze Music	"Instrument Amplifiers, Pedals & Accessories"
Dedalo Fx	Golden Hawk	"Instrument Amplifiers, Pedals & Accessories"
Demeter	Demeter	"Instrument Amplifiers, Pedals & Accessories"
Diamond Amplification	"Diamond
Amplification"	"Instrument Amplifiers, Pedals & Accessories"
DigiTech	Erikson Music	"Instrument Amplifiers, Pedals & Accessories"
Disaster Area Designs	Search & Distro	"Instrument Amplifiers, Pedals & Accessories"
DV Mark	Erikson Music	"Instrument Amplifiers, Pedals & Accessories"
Eastwood Black Box Series	"Eastwood
Guitars"	"Instrument Amplifiers, Pedals & Accessories"
EBS	Launch Music	"Instrument Amplifiers, Pedals & Accessories"
Electro-Harmonix	Electro-Harmonix	"Instrument Amplifiers, Pedals & Accessories"
Eminence	"McBride, Q-Components"	"Instrument Amplifiers, Pedals & Accessories"
EMMA Electronic	Godlyke	"Instrument Amplifiers, Pedals & Accessories"
Empress	Empress Effects	"Instrument Amplifiers, Pedals & Accessories"
Eventide	Eventide	"Instrument Amplifiers, Pedals & Accessories"
Fortin	Fortin	"Instrument Amplifiers, Pedals & Accessories"
FoxGear Pedals	Search & Distro	"Instrument Amplifiers, Pedals & Accessories"
Frost Giant Electronics	Search & Distro	"Instrument Amplifiers, Pedals & Accessories"
Fuzzrocious Pedals	Search & Distro	"Instrument Amplifiers, Pedals & Accessories"
GFI System	Search & Distro	"Instrument Amplifiers, Pedals & Accessories"
Gorilla	Pignose-Gorilla	"Instrument Amplifiers, Pedals & Accessories"
Greenhouse Effects	Search & Distro	"Instrument Amplifiers, Pedals & Accessories"
Greer Amps	Search & Distro	"Instrument Amplifiers, Pedals & Accessories"
Gurus Pedals	Search & Distro	"Instrument Amplifiers, Pedals & Accessories"
Hammond	Music Marketing	"Instrument Amplifiers, Pedals & Accessories"
Hartke	Yorkville Sound	"Instrument Amplifiers, Pedals & Accessories"
Haunted Labs	Search & Distro	"Instrument Amplifiers, Pedals & Accessories"
HeadRush	inMusic	"Instrument Amplifiers, Pedals & Accessories"
Hilbish Design	Search & Distro	"Instrument Amplifiers, Pedals & Accessories"
Hotone	Hal Leonard	"Instrument Amplifiers, Pedals & Accessories"
Hughes & Kettner	Yorkville Sound	"Instrument Amplifiers, Pedals & Accessories"
IdiotBox Effects	Search & Distro	"Instrument Amplifiers, Pedals & Accessories"
Industrialectric	Industrialectric	"Instrument Amplifiers, Pedals & Accessories"
ISP Technologies	ISP Technologies	"Instrument Amplifiers, Pedals & Accessories"
Jescar	Next Gen Musical	"Instrument Amplifiers, Pedals & Accessories"
JET Pedals	Search & Distro	"Instrument Amplifiers, Pedals & Accessories"
Kager	Pignose-Gorilla	"Instrument Amplifiers, Pedals & Accessories"
Kayline	Next Gen Musical	"Instrument Amplifiers, Pedals & Accessories"
Keeley Electronics	SFM	"Instrument Amplifiers, Pedals & Accessories"
Korg	Korg Canada	"Instrument Amplifiers, Pedals & Accessories"
Laney	Launch Music	"Instrument Amplifiers, Pedals & Accessories"
LunaStone	LunaStone	"Instrument Amplifiers, Pedals & Accessories"
Mad Professor	Mad Professor	"Instrument Amplifiers, Pedals & Accessories"
Markbass	Erikson Music	"Instrument Amplifiers, Pedals & Accessories"
Marshall	Erikson Music	"Instrument Amplifiers, Pedals & Accessories"
Mastery Bridges	Search & Distro	"Instrument Amplifiers, Pedals & Accessories"
Maxon	KO Music	"Instrument Amplifiers, Pedals & Accessories"
Mesa/Boogie	"Mesa/Boogie, Yorkville Sound"	"Instrument Amplifiers, Pedals & Accessories"
Milkman Sound	Search & Distro	"Instrument Amplifiers, Pedals & Accessories"
Mission Engineering	Mission Engineering	"Instrument Amplifiers, Pedals & Accessories"
Mojo Hand	Search & Distro	"Instrument Amplifiers, Pedals & Accessories"
Monster Effects	Search & Distro	"Instrument Amplifiers, Pedals & Accessories"
Montreux Pedals	Search & Distro	"Instrument Amplifiers, Pedals & Accessories"
Morley Pedals	Hal Leonard	"Instrument Amplifiers, Pedals & Accessories"
Nektar	Music Marketing	"Instrument Amplifiers, Pedals & Accessories"
NUX	B&J Music	"Instrument Amplifiers, Pedals & Accessories"
Nux	Kana Music	"Instrument Amplifiers, Pedals & Accessories"
Orange Amplification	Launch Music	"Instrument Amplifiers, Pedals & Accessories"
Outlaw Effects	SFM	"Instrument Amplifiers, Pedals & Accessories"
OverToner	Sherlock Audio	"Instrument Amplifiers, Pedals & Accessories"
Oxygen	Oxygen Audio	"Instrument Amplifiers, Pedals & Accessories"
Peavey	Peavey	"Instrument Amplifiers, Pedals & Accessories"
Pedaltrain	KO Music	"Instrument Amplifiers, Pedals & Accessories"
Penn Elcom	Next Gen Musical	"Instrument Amplifiers, Pedals & Accessories"
Pignose	Pignose-Gorilla	"Instrument Amplifiers, Pedals & Accessories"
Pigtronix	B&J Music	"Instrument Amplifiers, Pedals & Accessories"
Radias	Sherlock Audio	"Instrument Amplifiers, Pedals & Accessories"
Rainger FX	Search & Distro	"Instrument Amplifiers, Pedals & Accessories"
Randall Amplification	B&J Music	"Instrument Amplifiers, Pedals & Accessories"
Red Panda	Hal Leonard	"Instrument Amplifiers, Pedals & Accessories"
Revv	Revv	"Instrument Amplifiers, Pedals & Accessories"
Rivera	Rivera	"Instrument Amplifiers, Pedals & Accessories"
RockBoard by Warick	Launch Music	"Instrument Amplifiers, Pedals & Accessories"
Ruby Tubes	Audionova	"Instrument Amplifiers, Pedals & Accessories"
Singular Sound	Launch Music	"Instrument Amplifiers, Pedals & Accessories"
Soundtech	Coast Music	"Instrument Amplifiers, Pedals & Accessories"
Spaceman Effects	Search & Distro	"Instrument Amplifiers, Pedals & Accessories"
SpeakerMate	Sherlock Audio	"Instrument Amplifiers, Pedals & Accessories"
Stagecraft	Mission Engineering	"Instrument Amplifiers, Pedals & Accessories"
Stringjoy	Search & Distro	"Instrument Amplifiers, Pedals & Accessories"
Subdecay	Search & Distro	"Instrument Amplifiers, Pedals & Accessories"
Supro	B&J Music	"Instrument Amplifiers, Pedals & Accessories"
Switchcraft/Conxall	Next Gen Musical	"Instrument Amplifiers, Pedals & Accessories"
Tape Audio Co.	Search & Distro	"Instrument Amplifiers, Pedals & Accessories"
Tech 21	Tech 21	"Instrument Amplifiers, Pedals & Accessories"
Teisco	SFM	"Instrument Amplifiers, Pedals & Accessories"
Temple Audio	Temple Audio	"Instrument Amplifiers, Pedals & Accessories"
ThorpyFX	Search & Distro	"Instrument Amplifiers, Pedals & Accessories"
Tom's Lee	Kana Music	"Instrument Amplifiers, Pedals & Accessories"
ToneChamber	Sherlock Audio	"Instrument Amplifiers, Pedals & Accessories"
Tortuga Effects	Search & Distro	"Instrument Amplifiers, Pedals & Accessories"
Trace Elliot	Peavey	"Instrument Amplifiers, Pedals & Accessories"
Transparence	Transparence	"Instrument Amplifiers, Pedals & Accessories"
Traynor	Yorkville Sound	"Instrument Amplifiers, Pedals & Accessories"
Truetone	Yorkville Sound	"Instrument Amplifiers, Pedals & Accessories"
TWA Fly Boys	Godlyke	"Instrument Amplifiers, Pedals & Accessories"
TWA Hand Built	Godlyke	"Instrument Amplifiers, Pedals & Accessories"
Two Notes Engineering	SFM	"Instrument Amplifiers, Pedals & Accessories"
Typhoon	D'Addario Canada	"Instrument Amplifiers, Pedals & Accessories"
UnderCab	Sherlock Audio	"Instrument Amplifiers, Pedals & Accessories"
Universal Audio	YSL Pro	"Instrument Amplifiers, Pedals & Accessories"
Vertex	Hal Leonard	"Instrument Amplifiers, Pedals & Accessories"
Vox	Korg Canada	"Instrument Amplifiers, Pedals & Accessories"
Warehouse Guitar Speakers	Diffusion Audio	"Instrument Amplifiers, Pedals & Accessories"
Wendell Fabrics/Mellotone	Next Gen Musical	"Instrument Amplifiers, Pedals & Accessories"
WMD	Search & Distro	"Instrument Amplifiers, Pedals & Accessories"
Wren and Cuff Pedals	Search & Distro	"Instrument Amplifiers, Pedals & Accessories"
XSonic	Diffusion Audio	"Instrument Amplifiers, Pedals & Accessories"
XVIVE	Yorkville Sound	"Instrument Amplifiers, Pedals & Accessories"
Yamaha	Yamaha Canada	"Instrument Amplifiers, Pedals & Accessories"
Zander Circuitry	Search & Bistro	"Instrument Amplifiers, Pedals & Accessories"
Akord Kvint	Counterpoint	Other Stringed Instruments & Accessories
Alabama	Coast Music	Other Stringed Instruments & Accessories
Alisyn	Aerospace Lubricants	Other Stringed Instruments & Accessories
Aloha	Kana Music	Other Stringed Instruments & Accessories
Alvarez	SFM	Other Stringed Instruments & Accessories
Amy Birch	Coast Music	Other Stringed Instruments & Accessories
Anton Breton	Saga Musical	Other Stringed Instruments & Accessories
Antoni	JHS	Other Stringed Instruments & Accessories
Antonio Scarlartti	Sinoman Music	Other Stringed Instruments & Accessories
Apple Creek	Coast Music	Other Stringed Instruments & Accessories
Aquila	Coast Music	Other Stringed Instruments & Accessories
Aquila Corde	Kanile'a	Other Stringed Instruments & Accessories
Arcos	Bosco Violin	Other Stringed Instruments & Accessories
Arcos Brasil	The Sound Post	Other Stringed Instruments & Accessories
Aubert	Bosco Violin	Other Stringed Instruments & Accessories
Augustine	Coast Music	Other Stringed Instruments & Accessories
Bois d'Harmonie	Bosco Violin	Other Stringed Instruments & Accessories
Cadenza	Bosco Violin	Other Stringed Instruments & Accessories
Camac Harps	Jules Saint-Michel	Other Stringed Instruments & Accessories
Celes	Celestial Musical	Other Stringed Instruments & Accessories
Celestial Sound	Celestial Musical	Other Stringed Instruments & Accessories
Corelli	"Jules Saint-Michel, The Sound Post"	Other Stringed Instruments & Accessories
Cremona	Saga Musical	Other Stringed Instruments & Accessories
D'Addario Orchestral	D'Addario Canada	Other Stringed Instruments & Accessories
Deering Banjos	Deering	Other Stringed Instruments & Accessories
Despiau	Bosco Violin	Other Stringed Instruments & Accessories
Diamond Head	"B&J Music, Saga Musical"	Other Stringed Instruments & Accessories
Doerfler	Bosco Violin	Other Stringed Instruments & Accessories
D�rfler Bows	Jules Saint-Michel	Other Stringed Instruments & Accessories
Dusty Strings	Dusty Strings	Other Stringed Instruments & Accessories
Eastar	Donner	Other Stringed Instruments & Accessories
Eastman	Eastman Music	Other Stringed Instruments & Accessories
Eddy Fin	Chesbro Music	Other Stringed Instruments & Accessories
Emus	Empire Music	Other Stringed Instruments & Accessories
Everest Shoulder Rests	Counterpoint	Other Stringed Instruments & Accessories
Flight Instruments	Hal Leonard	Other Stringed Instruments & Accessories
Walton Irish	Hal Leonard	Other Stringed Instruments & Accessories
GEWA	Bosco Violin	Other Stringed Instruments & Accessories
Giovanni Viotti	Sinoman Music	Other Stringed Instruments & Accessories
Glasser	Bosco Violin	Other Stringed Instruments & Accessories
Gold Tone	Yorkville Sound	Other Stringed Instruments & Accessories
Goldbrokat	Counterpoint	Other Stringed Instruments & Accessories
Goodtime	Deering	Other Stringed Instruments & Accessories
Gotz	Geo. Heinl	Other Stringed Instruments & Accessories
Hamano	Saga Musical	Other Stringed Instruments & Accessories
Harpsicle Harps	Counterpoint	Other Stringed Instruments & Accessories
Headway Music Audio	Counterpoint	Other Stringed Instruments & Accessories
Heinrich Gill	Geo. Heinl	Other Stringed Instruments & Accessories
Hidersine	Counterpoint	Other Stringed Instruments & Accessories
Hill	Counterpoint	Other Stringed Instruments & Accessories
Hohner	Coast Music	Other Stringed Instruments & Accessories
Honolua Ukuleles	Honolua Ukuleles	Other Stringed Instruments & Accessories
Hora	Counterpoint	Other Stringed Instruments & Accessories
Islander by Kanile`a	Kanile`a	Other Stringed Instruments & Accessories
Jargar	"Bosco Violin, Counterpoint, Geo. Heinl, Jules Saint-Michel, The Sound Post"	Other Stringed Instruments & Accessories
Jay Haide	The Sound Post	Other Stringed Instruments & Accessories
Kahua	Hal Leonard	Other Stringed Instruments & Accessories
Kahuna	AP International	Other Stringed Instruments & Accessories
Kala	Coast Music	Other Stringed Instruments & Accessories
Keith	Beacon Banjo	Other Stringed Instruments & Accessories
Kentucky Mandolins	Saga Musical	Other Stringed Instruments & Accessories
Knilling	St. Louis Music	Other Stringed Instruments & Accessories
Knoll	The Sound Post	Other Stringed Instruments & Accessories
Korolia	Bosco Violin	Other Stringed Instruments & Accessories
Kun Shoulder Rest	"Bosco Violin, Coast Music, Counterpoint, Jules Saint-Michel, Kun Shoulder"	Other Stringed Instruments & Accessories
Laka	"5th Crown, JHS"	Other Stringed Instruments & Accessories
Larsen	Bosco Violin	Other Stringed Instruments & Accessories
Leho Ukuleles	Yorkville Sound	Other Stringed Instruments & Accessories
Lenzner	Jules Saint-Michel	Other Stringed Instruments & Accessories
Mach	"Bosco Violin, Jules Saint-Michel"	Other Stringed Instruments & Accessories
Mahalo	Coast Music	Other Stringed Instruments & Accessories
Menzel	Coast Music	Other Stringed Instruments & Accessories
Ming Jiang Zhu	Sinoman Music	Other Stringed Instruments & Accessories
Ohana	Groove Masters	Other Stringed Instruments & Accessories
Piastro	Geo. Heinl	Other Stringed Instruments & Accessories
Pirastro	"Bosco Violin, Counterpoint, Jules Saint-Michel, The Sound Post"	Other Stringed Instruments & Accessories
Primo	Sinoman Music	Other Stringed Instruments & Accessories
Revelle Bows	Counterpoint	Other Stringed Instruments & Accessories
Rocky Top	Chesbro Music	Other Stringed Instruments & Accessories
Roth	Jules Saint-Michel	Other Stringed Instruments & Accessories
Sandner	Jules Saint-Michel	Other Stringed Instruments & Accessories
Savarez	Coast Music	Other Stringed Instruments & Accessories
Selmer USA	Conn-Selmer	Other Stringed Instruments & Accessories
Stentor	Counterpoint	Other Stringed Instruments & Accessories
Stretto	Bosco Violin	Other Stringed Instruments & Accessories
Strunal	"Geo. Heinl, Jules Saint-Michel"	Other Stringed Instruments & Accessories
Super-Sensitive - Red Label	D'Addario Canada	Other Stringed Instruments & Accessories
Suzuki	Alfred Music	Other Stringed Instruments & Accessories
Teller	Bosco Violin	Other Stringed Instruments & Accessories
Tempel	Bosco Violin	Other Stringed Instruments & Accessories
Tenbrooks	Deering	Other Stringed Instruments & Accessories
Thomastik-Infeld	"Bosco Violin, Coast Music, Counterpoint, Geo. Heinl, Jules Saint-Michel, The Sound Post"	Other Stringed Instruments & Accessories
Vega	Deering	Other Stringed Instruments & Accessories
Vincenzo Bellini	Sinoman Music	Other Stringed Instruments & Accessories
Viva	Bosco Violin	Other Stringed Instruments & Accessories
W.E. Hill & Sons	Coast Music	Other Stringed Instruments & Accessories
Warchal	Bosco Violin	Other Stringed Instruments & Accessories
Westminster	Bosco Violin	Other Stringed Instruments & Accessories
Wittner	"Coast Music, Counterpoint"	Other Stringed Instruments & Accessories
Wolf	"Bosco Violin, Jules Saint-Michel"	Other Stringed Instruments & Accessories
Accu Cable	SFM	Other Stringed Instruments & Accessories
Xue Chang Xun	Sinoman Music	Cables & Interconnect Products
Zev	D'Addario Canada	Cables & Interconnect Products
Acorn Instruments	Music Marketing	"Pianos, Keyboards, Synthesizers & Accessories"
Albert Weber	PAL Sound	"Pianos, Keyboards, Synthesizers & Accessories"
Allen Audio	Schmidt Piano	"Pianos, Keyboards, Synthesizers & Accessories"
Applied Acoustic Systems	"Applied Acoustic
Systems"	"Pianos, Keyboards, Synthesizers & Accessories"
Arturia	Korg Canada	"Pianos, Keyboards, Synthesizers & Accessories"
Ashun Sound Machines	B&J Music	"Pianos, Keyboards, Synthesizers & Accessories"
Baldwin	Baldwin	"Pianos, Keyboards, Synthesizers & Accessories"
Boston	Steinway & Sons	"Pianos, Keyboards, Synthesizers & Accessories"
Broadway	Kana Music	"Pianos, Keyboards, Synthesizers & Accessories"
Casio	SFM	"Pianos, Keyboards, Synthesizers & Accessories"
Classic MIDI Works	Artisan Classic	"Pianos, Keyboards, Synthesizers & Accessories"
Classic Organ Works	Artisan Classic	"Pianos, Keyboards, Synthesizers & Accessories"
Concerto	GRK Manufacturing	"Pianos, Keyboards, Synthesizers & Accessories"
Cory Keyboard Products	Counterpoint	"Pianos, Keyboards, Synthesizers & Accessories"
Dabell	Golden Hawk	"Pianos, Keyboards, Synthesizers & Accessories"
Dexibell	Proel	"Pianos, Keyboards, Synthesizers & Accessories"
Dubreq Stylophone	Dubreq	"Pianos, Keyboards, Synthesizers & Accessories"
Eminent Church Organs	Schmidt Piano	"Pianos, Keyboards, Synthesizers & Accessories"
Essex	Steinway & Sons	"Pianos, Keyboards, Synthesizers & Accessories"
Harris Malodicas	Harris Musical	"Pianos, Keyboards, Synthesizers & Accessories"
Humes & Berg	Humes & Berg	"Pianos, Keyboards, Synthesizers & Accessories"
Intellijel	Intellijel	"Pianos, Keyboards, Synthesizers & Accessories"
Jansen	Paul L. Jansen	"Pianos, Keyboards, Synthesizers & Accessories"
Kawai	Kawai	"Pianos, Keyboards, Synthesizers & Accessories"
Kayserburg	Loewen	"Pianos, Keyboards, Synthesizers & Accessories"
Keytek	Kana Music	"Pianos, Keyboards, Synthesizers & Accessories"
KV331	Music Marketing	"Pianos, Keyboards, Synthesizers & Accessories"
M-Audio	inMusic	"Pianos, Keyboards, Synthesizers & Accessories"
Mafco	GRK Manufacturing	"Pianos, Keyboards, Synthesizers & Accessories"
Medeli	B&J Music	"Pianos, Keyboards, Synthesizers & Accessories"
MIDIjet Pro	Artisan Classic	"Pianos, Keyboards, Synthesizers & Accessories"
Mobileer	GRK Manufacturing	"Pianos, Keyboards, Synthesizers & Accessories"
Modal Electronics	YSL Pro	"Pianos, Keyboards, Synthesizers & Accessories"
Moog Music	SFM	"Pianos, Keyboards, Synthesizers & Accessories"
Nord	Erikson Music	"Pianos, Keyboards, Synthesizers & Accessories"
Novation	Erikson Audio	"Pianos, Keyboards, Synthesizers & Accessories"
Pearl River	Loewen	"Pianos, Keyboards, Synthesizers & Accessories"
PianoDisc	PianoDisc	"Pianos, Keyboards, Synthesizers & Accessories"
Ritm�ller	Loewen	"Pianos, Keyboards, Synthesizers & Accessories"
Roland	Roland Canada	"Pianos, Keyboards, Synthesizers & Accessories"
Schmidt Classique Schoenhut	Golden Hawk	"Pianos, Keyboards, Synthesizers & Accessories"
Shigeru Kawai	Kawai	"Pianos, Keyboards, Synthesizers & Accessories"
Steinway & Sons	Steinway & Sons	"Pianos, Keyboards, Synthesizers & Accessories"
Studiologic	B&J Music	"Pianos, Keyboards, Synthesizers & Accessories"
Viscount	"Artisan Classic, Schmidt Piano"	"Pianos, Keyboards, Synthesizers & Accessories"
Weber	PAL Sound	"Pianos, Keyboards, Synthesizers & Accessories"
Wren	GRK Manufacturing	"Pianos, Keyboards, Synthesizers & Accessories"
Young Chang	PAL Sound	"Pianos, Keyboards, Synthesizers & Accessories"
AirStream	Scott’s Highland	Band Instruments & Accessories
Al Cass	Counterpoint	Band Instruments & Accessories
Amati Heritage	Amati USA	Band Instruments & Accessories
Amati Vantage	Amati USA	Band Instruments & Accessories
American Classic Kazoos	D'Addario Canada	Band Instruments & Accessories
Antigua	St. Louis Music	Band Instruments & Accessories
Antoine Courtois	Buffet Crampon	Band Instruments & Accessories
Armstrong	Conn-Selmer	Band Instruments & Accessories
Aulos	Empire Music	Band Instruments & Accessories
B&S	Buffet Crampon	Band Instruments & Accessories
Backun	"Backun, Eastman Music"	Band Instruments & Accessories
Bari	Bari Woodwinds	Band Instruments & Accessories
Besson	Buffet Crampon	Band Instruments & Accessories
BG Franck Bichon	Counterpoint	Band Instruments & Accessories
Blessing	St. Louis Music	Band Instruments & Accessories
Boveda	Counterpoint	Band Instruments & Accessories
Buffet Crampon	Buffet Crampon	Band Instruments & Accessories
"C.G. Conn, Holton, King"	Conn-Selmer	Band Instruments & Accessories
Ch�teau	Ch�teau Music USA	Band Instruments & Accessories
Chopsaver	Counterpoint	Band Instruments & Accessories
Clarke Tin Whistle	Counterpoint	Band Instruments & Accessories
Compass Ligatures	St. Louis Music	Band Instruments & Accessories
D'Addario Woodwinds	D'Addario Canada	Band Instruments & Accessories
Delta Blues	Coast Music	Band Instruments & Accessories
Dolmetsch	Counterpoint	Band Instruments & Accessories
Dukoff	Bobby Dukoff 	Band Instruments & Accessories
Edwards	Getzen	Band Instruments & Accessories
F.E. Olds	F.E. Olds	Band Instruments & Accessories
Flavoreeds	Flavoreeds	Band Instruments & Accessories
G. Leblanc Group	Conn-Selmer	Band Instruments & Accessories
Gabbanelli	Gabbanelli	Band Instruments & Accessories
Gemeinhardt	Gemeinhardt	Band Instruments & Accessories
Generation	Coast Music	Band Instruments & Accessories
Getzen	Getzen	Band Instruments & Accessories
Griego	Getzen	Band Instruments & Accessories
Hall Crystal Flutes	Hall Crystal Flutes	Band Instruments & Accessories
Hans Hoyer	Buffet Crampon	Band Instruments & Accessories
Harmon Mutes	Counterpoint	Band Instruments & Accessories
Henri Selmer Paris	Conn-Selmer	Band Instruments & Accessories
Hering Harmonicas	Kelley Distribution	Band Instruments & Accessories
Hite	JJ Babbitt	Band Instruments & Accessories
HW Brass-Saver	St. Louis Music	Band Instruments & Accessories
HW Pad-Saver	St. Louis Music	Band Instruments & Accessories
J. Scherzer	Buffet Crampon	Band Instruments & Accessories
JHS Hornby	JHS	Band Instruments & Accessories
JJ Babbitt	JJ Babbitt	Band Instruments & Accessories
JodyJazz	JodyJazz	Band Instruments & Accessories
Jones Double Reed Products	Counterpoint	Band Instruments & Accessories
Josef Teller	Counterpoint	Band Instruments & Accessories
JT Lamy Bows	Counterpoint	Band Instruments & Accessories
Julius Keilwerth	Buffet Crampon	Band Instruments & Accessories
Juno	Coast Music	Band Instruments & Accessories
Jupiter	Coast Music	Band Instruments & Accessories
Laskey	Laskey	Band Instruments & Accessories
Lee Oskar	B&J Music	Band Instruments & Accessories
Legere Reeds	Counterpoint	Band Instruments & Accessories
Marca Reeds	Counterpoint	Band Instruments & Accessories
Marcinkiewicz	Marcinkiewicz	Band Instruments & Accessories
Meinl	Meinl USA	Band Instruments & Accessories
Melton Meinl Weston	Buffet Crampon	Band Instruments & Accessories
Meyer	JJ Babbitt	Band Instruments & Accessories
Meyer Bros.	JJ Babbitt	Band Instruments & Accessories
Montford	Counterpoint	Band Instruments & Accessories
Mr. Music	Flavoreeds	Band Instruments & Accessories
Mukikim	Golden Hawk	Band Instruments & Accessories
Mutec Mutes	Counterpoint	Band Instruments & Accessories
Narragansett	Harris Musical	Band Instruments & Accessories
Odyssey	SFM	Band Instruments & Accessories
Otto Link	JJ Babbitt	Band Instruments & Accessories
P. Mauriat	St. Louis Music	Band Instruments & Accessories
Paremenon	Buffet Crampon	Band Instruments & Accessories
Pearl Flutes	Pearl	Band Instruments & Accessories
Phaeton	PJLA Music	Band Instruments & Accessories
Piemaria Accordions	FRM Enterprises	Band Instruments & Accessories
Piper's Choice	Scott's Highland	Band Instruments & Accessories
Pops' Products	Counterpoint	Band Instruments & Accessories
Prestini	Prestini Reed	Band Instruments & Accessories
Re.corder	Proel	Band Instruments & Accessories
ReedGeek	Counterpoint	Band Instruments & Accessories
Revolution Drum	Golden Hawk	Band Instruments & Accessories
Reynolds	F.E. Olds	Band Instruments & Accessories
Rigoutat	Buffet Crampon	Band Instruments & Accessories
Rohema Percussion	Golden Hawk	Band Instruments & Accessories
Rovner Products	"Counterpoint, Rovner"	Band Instruments & Accessories
S.E. Shires	Eastman Music	Band Instruments & Accessories
Sax Dakota USA	PJLA Music	Band Instruments & Accessories
Seydel Harmonicas	Counterpoint	Band Instruments & Accessories
Sinclair	Coast Music	Band Instruments & Accessories
Snareweight	Golden Hawk	Band Instruments & Accessories
Stack Ring Percussion	Golden Hawk	Band Instruments & Accessories
Stageworks Gear	Golden Hawk	Band Instruments & Accessories
Sugal Mouthpieces	Sugal Mouthpieces	Band Instruments & Accessories
Techra	Golden Hawk	Band Instruments & Accessories
Tony Dixon Whistles	Counterpoint	Band Instruments & Accessories
Tuner Fish Lug Locks	Golden Hawk	Band Instruments & Accessories
Ultra-Pure Oils	Counterpoint	Band Instruments & Accessories
Vandoren	Coast Music	Band Instruments & Accessories
Verne Q. Powell	Buffet Crampon	Band Instruments & Accessories
Vincent Bach	Conn-Selmer	Band Instruments & Accessories
W. Schreiber	Buffet Crampon	Band Instruments & Accessories
Warwick Music Group	St. Louis Music	Band Instruments & Accessories
Wm. Kratt	Counterpoint	Band Instruments & Accessories
Wm. S. Haynes	Eastman Music	Band Instruments & Accessories
Xeros	Counterpoint	Band Instruments & Accessories
XO	Coast Music	Band Instruments & Accessories
Yanagisawa	Conn-Selmer	Band Instruments & Accessories
Zonda	St. Louis Music	Band Instruments & Accessories
2Box	Launch Music	"Drums, Percussion Products & Accessories"
Adams	Pearl	"Drums, Percussion Products & Accessories"
Ahead Products	Big Bang	"Drums, Percussion Products & Accessories"
Alice	Kana Music	"Drums, Percussion Products & Accessories"
Amedia Cymbals	Golden Hawk	"Drums, Percussion Products & Accessories"
Baldman	Baldman	"Drums, Percussion Products & Accessories"
Balter Mallets	Coast Music	"Drums, Percussion Products & Accessories"
Bergerault Percussions	Hoshino USA	"Drums, Percussion Products & Accessories"
Bass Drum O's	Big Bang	"Drums, Percussion Products & Accessories"
Big Fat Snare Drum	"Big Bang, Golden Hawk"	"Drums, Percussion Products & Accessories"
Boomwhackers	B&J Music	"Drums, Percussion Products & Accessories"
Bosphorus Cymbals	Golden Hawk	"Drums, Percussion Products & Accessories"
Buckaroo	Harris Musical	"Drums, Percussion Products & Accessories"
Carlsbro	Coast Music	"Drums, Percussion Products & Accessories"
Crazy Johns Polish	Big Bang	"Drums, Percussion Products & Accessories"
Cymbag	Big Bang	"Drums, Percussion Products & Accessories"
Cymbal Crown	Big Bang	"Drums, Percussion Products & Accessories"
Cymbal Sox	Cymbal Sox	"Drums, Percussion Products & Accessories"
Cympad	"Big Bang, Golden Hawk"	"Drums, Percussion Products & Accessories"
Danmar	Big Bang	"Drums, Percussion Products & Accessories"
ddrum	Armadillo Enterprises	"Drums, Percussion Products & Accessories"
DG Cajons	Big Bang	"Drums, Percussion Products & Accessories"
Dixon	"B&J Music, St. Louis Music"	"Drums, Percussion Products & Accessories"
Drum Doctor	Wyres	"Drums, Percussion Products & Accessories"
Drum N Base	Big Bang	"Drums, Percussion Products & Accessories"
Drum Workshop	"B&J Music, Drum Workshop"	"Drums, Percussion Products & Accessories"
Drum Wraps by Lumigraf	Lumigraf 	"Drums, Percussion Products & Accessories"
Drumdial	Big Bang	"Drums, Percussion Products & Accessories"
Drumtacs	Big Bang	"Drums, Percussion Products & Accessories"
DS Drum	DS Drum	"Drums, Percussion Products & Accessories"
Dunnett Classic	Dunnett Classic	"Drums, Percussion Products & Accessories"
Dunnett Parts & Drum Heads	Big Bang	"Drums, Percussion Products & Accessories"
Eccentric Systems	Big Bang	"Drums, Percussion Products & Accessories"
Eucatape	Big Bang	"Drums, Percussion Products & Accessories"
Evans	D'Addario Canada	"Drums, Percussion Products & Accessories"
Fat Cat Snappy Snares	Big Bang	"Drums, Percussion Products & Accessories"
Finhol	Big Bang	"Drums, Percussion Products & Accessories"
FLIX	Big Bang	"Drums, Percussion Products & Accessories"
Gauger Percussion	Big Bang	"Drums, Percussion Products & Accessories"
George Way Drum Co.	Dunnett Classic	"Drums, Percussion Products & Accessories"
Gibralter	B&J Music	"Drums, Percussion Products & Accessories"
GMP	Groove Masters	"Drums, Percussion Products & Accessories"
GMP AirDrum	Groove Masters	"Drums, Percussion Products & Accessories"
Gon Bops	Gon Bops	"Drums, Percussion Products & Accessories"
Gorilla Snot	Big Bang	"Drums, Percussion Products & Accessories"
Granite Percussion	Yorkville Sound	"Drums, Percussion Products & Accessories"
Groove Juice	Launch Music	"Drums, Percussion Products & Accessories"
Groove Masters Percussion	Groove Masters	"Drums, Percussion Products & Accessories"
Grover Pro	Golden Hawk	"Drums, Percussion Products & Accessories"
HeadHunters	HeadHunters	"Drums, Percussion Products & Accessories"
Heartbeat Percussion	Heartbeat Distributors	"Drums, Percussion Products & Accessories"
Hendrix Drums Sleeved Washers	Golden Hawk	"Drums, Percussion Products & Accessories"
Hingestix	Big Bang	"Drums, Percussion Products & Accessories"
IQ Plus	Hal Leonard	"Drums, Percussion Products & Accessories"
Istanbul Mehmet Cymbals	Tr�Root	"Drums, Percussion Products & Accessories"
Isthmus	Hal Leonard	"Drums, Percussion Products & Accessories"
Izzo	Groove Masters	"Drums, Percussion Products & Accessories"
Izzo Percussion	Kelley Distribution	"Drums, Percussion Products & Accessories"
Jingle Mute	Big Bang	"Drums, Percussion Products & Accessories"
K Brakes	Golden Hawk	"Drums, Percussion Products & Accessories"
KASZA Cymbals	Big Bang	"Drums, Percussion Products & Accessories"
KAT Percussion	Hal Leonard	"Drums, Percussion Products & Accessories"
Kelly Shu	Big Bang	"Drums, Percussion Products & Accessories"
Key-Cussion	Big Bang	"Drums, Percussion Products & Accessories"
Kick Block	Big Bang	"Drums, Percussion Products & Accessories"
KickPort	Big Bang	"Drums, Percussion Products & Accessories"
KickPro Pillows	Big Bang	"Drums, Percussion Products & Accessories"
Kilpatrick Sticks	Scott's Highland	"Drums, Percussion Products & Accessories"
Kindermallets	Empire Music	"Drums, Percussion Products & Accessories"
LogJam	Big Bang	"Drums, Percussion Products & Accessories"
Los Cabos	Yorkville Sound	"Drums, Percussion Products & Accessories"
Ludwig	Conn-Selmer	"Drums, Percussion Products & Accessories"
Ludwig-Musser	Conn-Selmer	"Drums, Percussion Products & Accessories"
Majestic	Coast Music	"Drums, Percussion Products & Accessories"
Mano Kids	Coast Music	"Drums, Percussion Products & Accessories"
Mano Percussion	Coast Music	"Drums, Percussion Products & Accessories"
Mapex	Yorkville Sound	"Drums, Percussion Products & Accessories"
Meridian	Kana Music	"Drums, Percussion Products & Accessories"
Metrophones	Big Bang	"Drums, Percussion Products & Accessories"
Mic Holders	Big Bang	"Drums, Percussion Products & Accessories"
Milestone Percussion	Dunnett Classic	"Drums, Percussion Products & Accessories"
Moongel	B&J Music	"Drums, Percussion Products & Accessories"
Nativo Percussion	Big Bang	"Drums, Percussion Products & Accessories"
Nino Percussion	Meinl USA	"Drums, Percussion Products & Accessories"
No Nuts Percussion	No Nuts Percussion	"Drums, Percussion Products & Accessories"
Pacific Drums & Percussion	B&J Music	"Drums, Percussion Products & Accessories"
Pearl	"Erikson Music, Pearl"	"Drums, Percussion Products & Accessories"
Pinch Clips	Golden Hawk	"Drums, Percussion Products & Accessories"
Pinchclip	Big Bang	"Drums, Percussion Products & Accessories"
PP Drums	JHS	"Drums, Percussion Products & Accessories"
ProLogix Percussion	Coast Music	"Drums, Percussion Products & Accessories"
Promark	D'Addario Canada	"Drums, Percussion Products & Accessories"
Promuco Percussion	B&J Music	"Drums, Percussion Products & Accessories"
Puresound	D'Addario Canada	"Drums, Percussion Products & Accessories"
R Class	Dunnett Classic	"Drums, Percussion Products & Accessories"
RB	Coast Music	"Drums, Percussion Products & Accessories"
Regal Tip	Regal Tip	"Drums, Percussion Products & Accessories"
Remo	Coast Music	"Drums, Percussion Products & Accessories"
Res-O-Tone	Dunnett Classic	"Drums, Percussion Products & Accessories"
Rhythm Tech	Coast Music	"Drums, Percussion Products & Accessories"
Roc-N-Soc	Roc-N-Soc	"Drums, Percussion Products & Accessories"
Rogers Drums & Accessories	Big Bang	"Drums, Percussion Products & Accessories"
RTOM	Big Bang	"Drums, Percussion Products & Accessories"
S-Hoops	Big Bang	"Drums, Percussion Products & Accessories"
Sabian	Sabian	"Drums, Percussion Products & Accessories"
Sakae	Korg Canada	"Drums, Percussion Products & Accessories"
Schlagwek	Kelley Distribution	"Drums, Percussion Products & Accessories"
Slap Klatz	"Golden Hawk, Hal Leonard"	"Drums, Percussion Products & Accessories"
Slingerland	Drum Workshop	"Drums, Percussion Products & Accessories"
Dream Cymbals	Dream Cymbals	"Drums, Percussion Products & Accessories"
Slug Percussion	Big Bang	"Drums, Percussion Products & Accessories"
Sonor	Coast Music	"Drums, Percussion Products & Accessories"
Sonor Orff	Coast Music	"Drums, Percussion Products & Accessories"
Sticks by the Pound	"Harris Musical

"	"Drums, Percussion Products & Accessories"
Studio 49	MMB Music	"Drums, Percussion Products & Accessories"
Tackle Instrument Supply	Big Bang	"Drums, Percussion Products & Accessories"
Tama	Hoshino USA	"Drums, Percussion Products & Accessories"
Tamburo	Proel	"Drums, Percussion Products & Accessories"
The Drummer's Grip	Big Bang	"Drums, Percussion Products & Accessories"
Thumb Thang	Big Bang	"Drums, Percussion Products & Accessories"
Tightscrew	Big Bang	"Drums, Percussion Products & Accessories"
TnR True Vibe	Golden Hawk	"Drums, Percussion Products & Accessories"
Toca Percussion	Launch Music	"Drums, Percussion Products & Accessories"
Traps Drums	Kelley Distribution	"Drums, Percussion Products & Accessories"
TreeWorks	Big Bang	"Drums, Percussion Products & Accessories"
TRS Custom Drums	TRS Custom Drums	"Drums, Percussion Products & Accessories"
Turkish Cymbals	Tr�Root	"Drums, Percussion Products & Accessories"
Tycoon	D'Addario Canada	"Drums, Percussion Products & Accessories"
Vater	Erikson Music	"Drums, Percussion Products & Accessories"
Vic Firth	Coast Music	"Drums, Percussion Products & Accessories"
Viper	BRTB	"Drums, Percussion Products & Accessories"
Walton's Music	The James Trading	"Drums, Percussion Products & Accessories"
Waltons	Coast Music	"Drums, Percussion Products & Accessories"
Westbury	Coast Music	"Drums, Percussion Products & Accessories"
Zildjian	"Coast Music

"	"Drums, Percussion Products & Accessories"
Ace	Audionova	"Bags, Cases, Straps, Racks, Stands, Mounts & Accessories"
Adam Hall Hardware	Adam Hall	"Bags, Cases, Straps, Racks, Stands, Mounts & Accessories"
AirTurn	Coast Music	"Bags, Cases, Straps, Racks, Stands, Mounts & Accessories"
Analog Cases	B&J Music	"Bags, Cases, Straps, Racks, Stands, Mounts & Accessories"
Anvil	Anvil Cases	"Bags, Cases, Straps, Racks, Stands, Mounts & Accessories"
Aria Lights	Counterpoint	"Bags, Cases, Straps, Racks, Stands, Mounts & Accessories"
Aroma	Kana Music	"Bags, Cases, Straps, Racks, Stands, Mounts & Accessories"
Ascot	Anvil Cases	"Bags, Cases, Straps, Racks, Stands, Mounts & Accessories"
Bam	Geo. Heinl	"Bags, Cases, Straps, Racks, Stands, Mounts & Accessories"
BAM	The Sound Post	"Bags, Cases, Straps, Racks, Stands, Mounts & Accessories"
Bam Franck	Counterpoint	"Bags, Cases, Straps, Racks, Stands, Mounts & Accessories"
Big Deal	Big Deal	"Bags, Cases, Straps, Racks, Stands, Mounts & Accessories"
Boblen	"Coast Music, Geo, Heinl"	"Bags, Cases, Straps, Racks, Stands, Mounts & Accessories"
Boulder	Geo. Heinl	"Bags, Cases, Straps, Racks, Stands, Mounts & Accessories"
Cabbage Cases	Cabbage Cases	"Bags, Cases, Straps, Racks, Stands, Mounts & Accessories"
Caisse Design	Caisse Design	"Bags, Cases, Straps, Racks, Stands, Mounts & Accessories"
Calzone	Anvil Cases	"Bags, Cases, Straps, Racks, Stands, Mounts & Accessories"
Cedar Creek Custom Cases	Cedar Creek	"Bags, Cases, Straps, Racks, Stands, Mounts & Accessories"
Chief	Legrand	"Bags, Cases, Straps, Racks, Stands, Mounts & Accessories"
Color Fold	Humes & Berg	"Bags, Cases, Straps, Racks, Stands, Mounts & Accessories"
Conquest	Impact Cases	"Bags, Cases, Straps, Racks, Stands, Mounts & Accessories"
Cooperstand	Launch Music	"Bags, Cases, Straps, Racks, Stands, Mounts & Accessories"
D&A	D'Addario Canada	"Bags, Cases, Straps, Racks, Stands, Mounts & Accessories"
Decksaver	Erikson Audio	"Bags, Cases, Straps, Racks, Stands, Mounts & Accessories"
Drumseeker	Humes & Berg	"Bags, Cases, Straps, Racks, Stands, Mounts & Accessories"
Drumslinger	Tough Traveler	"Bags, Cases, Straps, Racks, Stands, Mounts & Accessories"
E-Z Fold	Humes & Berg	"Bags, Cases, Straps, Racks, Stands, Mounts & Accessories"
ECM Cases	Engineered Case	"Bags, Cases, Straps, Racks, Stands, Mounts & Accessories"
Enduro	Humes & Berg	"Bags, Cases, Straps, Racks, Stands, Mounts & Accessories"
Enduro Pro	Humes & Berg	"Bags, Cases, Straps, Racks, Stands, Mounts & Accessories"
Fiberlex Cases	Big Deal	"Bags, Cases, Straps, Racks, Stands, Mounts & Accessories"
FRM	FRM Enterprises	"Bags, Cases, Straps, Racks, Stands, Mounts & Accessories"
Galaxy	Humes & Berg	"Bags, Cases, Straps, Racks, Stands, Mounts & Accessories"
Gard Bags	Gard Bags	"Bags, Cases, Straps, Racks, Stands, Mounts & Accessories"
Gator	Erikson Music	"Bags, Cases, Straps, Racks, Stands, Mounts & Accessories"
Gator Frameworks	Erikson Audio	"Bags, Cases, Straps, Racks, Stands, Mounts & Accessories"
Gator Pro	Erikson Audio	"Bags, Cases, Straps, Racks, Stands, Mounts & Accessories"
GK	Kana Music	"Bags, Cases, Straps, Racks, Stands, Mounts & Accessories"
Gravity Stands	Adam Hall	"Bags, Cases, Straps, Racks, Stands, Mounts & Accessories"
Grundorf	Hal Leonard	"Bags, Cases, Straps, Racks, Stands, Mounts & Accessories"
Hamilton Stands	Hal Leonard	"Bags, Cases, Straps, Racks, Stands, Mounts & Accessories"
Hardcase	Hoshino USA	"Bags, Cases, Straps, Racks, Stands, Mounts & Accessories"
Hercules	Erikson Audio	"Bags, Cases, Straps, Racks, Stands, Mounts & Accessories"
Humicase	Cordoba Music	"Bags, Cases, Straps, Racks, Stands, Mounts & Accessories"
Ingles	B&J Music	"Bags, Cases, Straps, Racks, Stands, Mounts & Accessories"
Isovox	RAD Distribution	"Bags, Cases, Straps, Racks, Stands, Mounts & Accessories"
K&M	SFM	"Bags, Cases, Straps, Racks, Stands, Mounts & Accessories"
Kaces	Ace Products	"Bags, Cases, Straps, Racks, Stands, Mounts & Accessories"
Kinsman	JHS	"Bags, Cases, Straps, Racks, Stands, Mounts & Accessories"
Levy's	Levy's	"Bags, Cases, Straps, Racks, Stands, Mounts & Accessories"
Light Pack	Multi-Caisses	"Bags, Cases, Straps, Racks, Stands, Mounts & Accessories"
Lock-It Straps	Audionova	"Bags, Cases, Straps, Racks, Stands, Mounts & Accessories"
Loxx	Blaze Music	"Bags, Cases, Straps, Racks, Stands, Mounts & Accessories"
Manhasset	Coast Music	"Bags, Cases, Straps, Racks, Stands, Mounts & Accessories"
Mighty Bright	Small World	"Bags, Cases, Straps, Racks, Stands, Mounts & Accessories"
MONO	SFM	"Bags, Cases, Straps, Racks, Stands, Mounts & Accessories"
Multi-Pack	Multi-Caisses	"Bags, Cases, Straps, Racks, Stands, Mounts & Accessories"
Multi-Pro	Multi-Caisses	"Bags, Cases, Straps, Racks, Stands, Mounts & Accessories"
N-Case System	Big Deal	"Bags, Cases, Straps, Racks, Stands, Mounts & Accessories"
Nanuk Cases	Big Deal	"Bags, Cases, Straps, Racks, Stands, Mounts & Accessories"
Neotech	Coast Music	"Bags, Cases, Straps, Racks, Stands, Mounts & Accessories"
Nomad	Nomad Cases	"Bags, Cases, Straps, Racks, Stands, Mounts & Accessories"
Pelican	"Big Deal, Cabbage Cases, Engineered Case, Georgia Case"	"Bags, Cases, Straps, Racks, Stands, Mounts & Accessories"
Perri's Leathers	Perri's Leathers	"Bags, Cases, Straps, Racks, Stands, Mounts & Accessories"
Piano Life Saver	Dampp-Chaser	"Bags, Cases, Straps, Racks, Stands, Mounts & Accessories"
Pig Hog Cables	Ace Products	"Bags, Cases, Straps, Racks, Stands, Mounts & Accessories"
Pro-X	AVL Media	"Bags, Cases, Straps, Racks, Stands, Mounts & Accessories"
Profile	Coast Music	"Bags, Cases, Straps, Racks, Stands, Mounts & Accessories"
ProRock Gear	AP International	"Bags, Cases, Straps, Racks, Stands, Mounts & Accessories"
Protechtor	Erikson Music	"Bags, Cases, Straps, Racks, Stands, Mounts & Accessories"
Protection Racket	B&J Music	"Bags, Cases, Straps, Racks, Stands, Mounts & Accessories"
Quik-Lok	Erikson Music	"Bags, Cases, Straps, Racks, Stands, Mounts & Accessories"
RATstands	"RATstands, Small World MUSIC-FOLDER, Yorkville Sound"	"Bags, Cases, Straps, Racks, Stands, Mounts & Accessories"
Reunion Blues	"Ace Products, Kinal"	"Bags, Cases, Straps, Racks, Stands, Mounts & Accessories"
RichtOn Straps	Audionova	"Bags, Cases, Straps, Racks, Stands, Mounts & Accessories"
Road Boss	Multi-Caisses	"Bags, Cases, Straps, Racks, Stands, Mounts & Accessories"
RockGear by Warwick	Launch Music	"Bags, Cases, Straps, Racks, Stands, Mounts & Accessories"
RocknRoller Multi-Cart	Ace Products	"Bags, Cases, Straps, Racks, Stands, Mounts & Accessories"
Sabian Performance Accessories	Sabian	"Bags, Cases, Straps, Racks, Stands, Mounts & Accessories"
Samson Audio & Wireless	Yorkville Sound	"Bags, Cases, Straps, Racks, Stands, Mounts & Accessories"
Seasun	Harris Musical	"Bags, Cases, Straps, Racks, Stands, Mounts & Accessories"
Sequenz	Korg Canada	"Bags, Cases, Straps, Racks, Stands, Mounts & Accessories"
SKB	"Cabbage Cases, Georgia Case, Impact Cases, Launch Music"	"Bags, Cases, Straps, Racks, Stands, Mounts & Accessories"
Sound Synergies	Audionova	"Bags, Cases, Straps, Racks, Stands, Mounts & Accessories"
Stage Mate	Chesbro Music	"Bags, Cases, Straps, Racks, Stands, Mounts & Accessories"
Stageline	B&J Music	"Bags, Cases, Straps, Racks, Stands, Mounts & Accessories"
Standback	Blaze Music	"Bags, Cases, Straps, Racks, Stands, Mounts & Accessories"
Stone Case	Chesbro Music	"Bags, Cases, Straps, Racks, Stands, Mounts & Accessories"
Storm	Engineered Case	"Bags, Cases, Straps, Racks, Stands, Mounts & Accessories"
Strukture	Ace Products	"Bags, Cases, Straps, Racks, Stands, Mounts & Accessories"
Superior Cases	Superior Cases	"Bags, Cases, Straps, Racks, Stands, Mounts & Accessories"
SwirlyGig	"Hal Leonard, SwirlyGig"	"Bags, Cases, Straps, Racks, Stands, Mounts & Accessories"
Target	Impact Cases	"Bags, Cases, Straps, Racks, Stands, Mounts & Accessories"
TCH	TCH Sales	"Bags, Cases, Straps, Racks, Stands, Mounts & Accessories"
TKL	TKL	"Bags, Cases, Straps, Racks, Stands, Mounts & Accessories"
Tough Traveler	Tough Traveler	"Bags, Cases, Straps, Racks, Stands, Mounts & Accessories"
Tour Rack	Multi-Caisses	"Bags, Cases, Straps, Racks, Stands, Mounts & Accessories"
TRIC Cases	Godin	"Bags, Cases, Straps, Racks, Stands, Mounts & Accessories"
Tuxedo	Humes & Berg	"Bags, Cases, Straps, Racks, Stands, Mounts & Accessories"
Ultimate Support	Ultimate Support	"Bags, Cases, Straps, Racks, Stands, Mounts & Accessories"
UNITEK	Techni+Contact	"Bags, Cases, Straps, Racks, Stands, Mounts & Accessories"
Wishbone	Blaze Music	"Bags, Cases, Straps, Racks, Stands, Mounts & Accessories"
Yorkville Sound	"Yorkville Sound

"	"Bags, Cases, Straps, Racks, Stands, Mounts & Accessories"
Alpine	Korg Canada	"Headphones, Hearing Protection, IEMs & Accessories"
Cherub Technology	Kana Music	"Headphones, Hearing Protection, IEMs & Accessories"
D'Addario Accessories	D'Addario Canada	"Headphones, Hearing Protection, IEMs & Accessories"
Musedo	Kana Music	"Headphones, Hearing Protection, IEMs & Accessories"
Peterson	Peterson Electro-Musical	"Headphones, Hearing Protection, IEMs & Accessories"
Roadie 2	Hal Leonard	"Headphones, Hearing Protection, IEMs & Accessories"
Seiko	B&J Music	"Headphones, Hearing Protection, IEMs & Accessories"
Snark Tuners	Yorkville Sound	"Headphones, Hearing Protection, IEMs & Accessories"
Tune-Bot	D'Addario Canada	"Headphones, Hearing Protection, IEMs & Accessories"
Adam Hall Stage Equipment	Adam Hall	"Headphones, Hearing Protection, IEMs & Accessories"
Amphenol	Rapco	"Headphones, Hearing Protection, IEMs & Accessories"
Asterope	Fishman	"Headphones, Hearing Protection, IEMs & Accessories"
AVPro Edge	SFM	"Headphones, Hearing Protection, IEMs & Accessories"
Basix	BRTB	"Headphones, Hearing Protection, IEMs & Accessories"
Belden	"BRTB, Cable Factory"	"Headphones, Hearing Protection, IEMs & Accessories"
Bryston	Bryston	"Headphones, Hearing Protection, IEMs & Accessories"
Bullet Train	SFM	"Headphones, Hearing Protection, IEMs & Accessories"
C2G	Legrand	"Headphones, Hearing Protection, IEMs & Accessories"
Cable Factory	Cable Factory	"Headphones, Hearing Protection, IEMs & Accessories"
Canare	SFM	"Headphones, Hearing Protection, IEMs & Accessories"
CBI Cables	Blaze Music	"Headphones, Hearing Protection, IEMs & Accessories"
Contour	BRTB	"Headphones, Hearing Protection, IEMs & Accessories"
Defender	Adam Hall	"Headphones, Hearing Protection, IEMs & Accessories"
Digiflex	SFM	"Headphones, Hearing Protection, IEMs & Accessories"
DLX Series	Yorkville Sound	"Headphones, Hearing Protection, IEMs & Accessories"
Evidence Audio	Audionova	"Headphones, Hearing Protection, IEMs & Accessories"
George L's	KO Music	"Headphones, Hearing Protection, IEMs & Accessories"
Groove Factory	Kana Music	"Headphones, Hearing Protection, IEMs & Accessories"
HOSA	Roland Canada	"Headphones, Hearing Protection, IEMs & Accessories"
KMMK SquarePlugs	Next Gen Musical	"Headphones, Hearing Protection, IEMs & Accessories"
Lava Cable	Rapco	"Headphones, Hearing Protection, IEMs & Accessories"
Leem	Coast Music	"Headphones, Hearing Protection, IEMs & Accessories"
Link	BRTB	"Headphones, Hearing Protection, IEMs & Accessories"
LINK Audio	Yorkville Sound	"Headphones, Hearing Protection, IEMs & Accessories"
Media	BRTB	"Headphones, Hearing Protection, IEMs & Accessories"
Monster	B&J Music	"Headphones, Hearing Protection, IEMs & Accessories"
Music 8	Music 8	"Headphones, Hearing Protection, IEMs & Accessories"
MXL	Hal Leonard	"Headphones, Hearing Protection, IEMs & Accessories"
Neutrik	"Rapco, SFM"	"Headphones, Hearing Protection, IEMs & Accessories"
Next Gen Cables	Next Gen Musical	"Headphones, Hearing Protection, IEMs & Accessories"
Pig Hog Cables	Ace Products	"Headphones, Hearing Protection, IEMs & Accessories"
Pivot-All	Godlyke	"Headphones, Hearing Protection, IEMs & Accessories"
Player	BRTB	"Headphones, Hearing Protection, IEMs & Accessories"
Power-All	"Godlyke, KO Music"	"Headphones, Hearing Protection, IEMs & Accessories"
Power-Grip	Godlyke	"Headphones, Hearing Protection, IEMs & Accessories"
Power-X	BRTB	"Headphones, Hearing Protection, IEMs & Accessories"
Proco	HPC	"Headphones, Hearing Protection, IEMs & Accessories"
ProCo Sound	Rapco	"Headphones, Hearing Protection, IEMs & Accessories"
RapcoHorizon	Rapco	"Headphones, Hearing Protection, IEMs & Accessories"
RAT	Rapco	"Headphones, Hearing Protection, IEMs & Accessories"
Revelation	Revelation Cable	"Headphones, Hearing Protection, IEMs & Accessories"
RoadHog	Rapco	"Headphones, Hearing Protection, IEMs & Accessories"
Soundcast	BRTB	"Headphones, Hearing Protection, IEMs & Accessories"
StageMASTER	Rapco	"Headphones, Hearing Protection, IEMs & Accessories"
Studio One	Yorkville Sound	"Headphones, Hearing Protection, IEMs & Accessories"
Switchcraft	"McBride, Q-Components, Rapco, Yorkville Sound"	"Headphones, Hearing Protection, IEMs & Accessories"
Theatron	BRTB	"Headphones, Hearing Protection, IEMs & Accessories"
Unity	BRTB	"Headphones, Hearing Protection, IEMs & Accessories"
Whirlwind	Whirlwind	"Headphones, Hearing Protection, IEMs & Accessories"
Xcalibur	BRTB	"Headphones, Hearing Protection, IEMs & Accessories"
512 Audio	Erikson Audio	Microphones & Accessories 
AKG	HPC	Microphones & Accessories 
American Audio	SFM	Microphones & Accessories 
Apex	Yorkville Sound	Microphones & Accessories 
Audio-Technica	Audio-Technica Canada	Microphones & Accessories 
Audix	Erikson Audio	Microphones & Accessories 
Austrian Audio	Music Marketing	Microphones & Accessories 
Avantone Pro	Erikson Audio	Microphones & Accessories 
Beachtek	Audio Distributors International	Microphones & Accessories 
C-Ducer	Audio Distributors International	Microphones & Accessories 
CAD Audio	Coast Music	Microphones & Accessories 
Coles Electroacoustics	YSL Pro	Microphones & Accessories 
Countryman Associates	Contact Distribution	Microphones & Accessories 
DPA	GerrAudio	Microphones & Accessories 
Dynamount	YSL Pro	Microphones & Accessories 
Ear Trumpet Labs	Ear Trumpet Labs	Microphones & Accessories 
Earthworks	Earthworks	Microphones & Accessories 
EV	Electro-Voice	Microphones & Accessories 
Galaxy Audio	"Audio Distributors
International"	Microphones & Accessories 
Golden Age Project	"Erikson Audio, RAD
Distribution"	Microphones & Accessories 
Heil Sound	"Hal Leonard, Heil Sound"	Microphones & Accessories 
LD Systems	Adam Hall	Microphones & Accessories 
Lewitt	Yorkville Sound	Microphones & Accessories 
Manley Labs	YSL Pro	Microphones & Accessories 
Mic-Muff Windshields	Olsen Audio	Microphones & Accessories 
Mojave Audio	YSL Pro	Microphones & Accessories 
Neumann	Sennheiser Canada	Microphones & Accessories 
Popscreen	St. Louis Music	Microphones & Accessories 
Proel	Proel	Microphones & Accessories 
R�DE Microphones	"Audio Distributors
International"	Microphones & Accessories 
Roswell	Roswell	Microphones & Accessories 
Royer Labs	YSL Pro	Microphones & Accessories 
Rycote	Audio Distributors International	Microphones & Accessories 
Saramonic	Erikson Audio	Microphones & Accessories 
sE Electronics	YSL Pro	Microphones & Accessories 
Sennheiser	Sennheiser Canada	Microphones & Accessories 
SHS Audio	Chesbro Music	Microphones & Accessories 
Shure	SFM	Microphones & Accessories 
Solomon Mics	Hal Leonard	Microphones & Accessories 
Sony	Sony	Microphones & Accessories 
SoundID Sonarworks	Music Marketing	Microphones & Accessories 
Soyuz Microphones	"Diffusion Audio,
Outside Sales"	Microphones & Accessories 
TechZone	TechZone	Microphones & Accessories 
Townsend Labs	YSL Pro	Microphones & Accessories 
Tula	Outside Sales	Microphones & Accessories 
United Studio Technologies	"RAD
Distribution"	Microphones & Accessories 
WindTech	Olsen Audio	Microphones & Accessories 
Yellowtec	Sennheiser Canada	Microphones & Accessories 
Ableton	Ableton	Recording/Studio Equipment & Accessories
ADAM Audio	YSL Pro	Recording/Studio Equipment & Accessories
Akai Professional	inMusic	Recording/Studio Equipment & Accessories
Alesis	inMusic	Recording/Studio Equipment & Accessories
Alto Professional	inMusic	Recording/Studio Equipment & Accessories
AMX	AMX Canada	Recording/Studio Equipment & Accessories
Angelbird	Audio Distributors International	Recording/Studio Equipment & Accessories
Antelope Audio	Antelope Audio	Recording/Studio Equipment & Accessories
Apogee	Music Marketing	Recording/Studio Equipment & Accessories
ART ProAudio	Yorkville Sound	Recording/Studio Equipment & Accessories
ATC	YSL Pro	Recording/Studio Equipment & Accessories
Audient	Erikson Pro	Recording/Studio Equipment & Accessories
Avid	SFM	Recording/Studio Equipment & Accessories
Band-in-a-Box	PG Music	Recording/Studio Equipment & Accessories
BDI	Focal Naim	Recording/Studio Equipment & Accessories
Benchmark	Benchmark	Recording/Studio Equipment & Accessories
Black Lion Audio	Erikson Audio	Recording/Studio Equipment & Accessories
CEntrance	CEntrance	Recording/Studio Equipment & Accessories
Clear Audio	Focal Naim	Recording/Studio Equipment & Accessories
Cranborne Audio	YSL Pro	Recording/Studio Equipment & Accessories
D.W. Fearn	D.W. Fearn	Recording/Studio Equipment & Accessories
Daking	TransAudio	Recording/Studio Equipment & Accessories
Digital Audio Labs	YSL Pro	Recording/Studio Equipment & Accessories
Dynaudio	"Yorkville Sound

"	Recording/Studio Equipment & Accessories
Event Electronics	Eventide	Recording/Studio Equipment & Accessories
Focal	Focal Naim	Recording/Studio Equipment & Accessories
Focal Professional	Focal Naim	Recording/Studio Equipment & Accessories
Focusrite	Erikson Audio	Recording/Studio Equipment & Accessories
Fostex	Erikson Audio	Recording/Studio Equipment & Accessories
Genelec	SFM	Recording/Studio Equipment & Accessories
Great River Electronics	Great River	Recording/Studio Equipment & Accessories
Hazelrigg Industries	D.W. Fearn	Recording/Studio Equipment & Accessories
HEDD	RAD Distribution	Recording/Studio Equipment & Accessories
Heritage Audio	Erikson Audio	Recording/Studio Equipment & Accessories
IK Multimedia	"Hal Leonard, Music Marketing"	Recording/Studio Equipment & Accessories
ISO-MAX	Jensen Transformers	Recording/Studio Equipment & Accessories
IsoAcoustics	Focal Naim	Recording/Studio Equipment & Accessories
iZotope	Hal Leonard	Recording/Studio Equipment & Accessories
Jensen Transformers	"Jensen, Radial"	Recording/Studio Equipment & Accessories
Juice Goose	Juise Goose	Recording/Studio Equipment & Accessories
Kahayan Audio	RAD Distribution	Recording/Studio Equipment & Accessories
KRK Studio Monitors	Yorkville Sound	Recording/Studio Equipment & Accessories
Lindell Audio	"Erikson Audio, RAD
Distribution"	Recording/Studio Equipment & Accessories
Mackie	Audio Distributors International	Recording/Studio Equipment & Accessories
Maono	Korg Canada	Recording/Studio Equipment & Accessories
Mc2	Audio Distributors International	Recording/Studio Equipment & Accessories
Merging Technologies	YSL Pro	Recording/Studio Equipment & Accessories
Middle Atlantic	Legrand	Recording/Studio Equipment & Accessories
MOTU	MOTU	Recording/Studio Equipment & Accessories
Musical Fidelity	Focal Naim	Recording/Studio Equipment & Accessories
Naim Audio	Focal Naim	Recording/Studio Equipment & Accessories
Palmer	Adam Hall	Recording/Studio Equipment & Accessories
PreSonus	"Erikson Audio, Fender"	Recording/Studio Equipment & Accessories
Prodipe	Kelley Distribution	Recording/Studio Equipment & Accessories
Radial	Radial	Recording/Studio Equipment & Accessories
RealBand	PG Music	Recording/Studio Equipment & Accessories
RealTracks	PG Music	Recording/Studio Equipment & Accessories
Reamp	Radial	Recording/Studio Equipment & Accessories
Rupert Neve Designs	YSL Pro	Recording/Studio Equipment & Accessories
Solid State Logic - SSL	SC Media	Recording/Studio Equipment & Accessories
Sound Performance Lab - SPL	Focal Naim	Recording/Studio Equipment & Accessories
Stedman	Stedman	Recording/Studio Equipment & Accessories
Superscope	Superscope	Recording/Studio Equipment & Accessories
Surgex	Erikson Audio	Recording/Studio Equipment & Accessories
Tac System	YSL Pro	Recording/Studio Equipment & Accessories
TASCAM	Erikson Audio	Recording/Studio Equipment & Accessories
TC Electronic	AVL Media	Recording/Studio Equipment & Accessories
TK Audio	RAD Distribution	Recording/Studio Equipment & Accessories
Warm Audio	Erikson Audio	Recording/Studio Equipment & Accessories
Wharfedale Pro	Erikson Audio	Recording/Studio Equipment & Accessories
2nd Sense Audio	Music Marketing	Music & Audio Software & Computer Products
Ableton	Ableton	Music & Audio Software & Computer Products
Acon Digital	Music Marketing	Music & Audio Software & Computer Products
Acoustica	Hal Leonard	Music & Audio Software & Computer Products
Antares	Hal Leonard	Music & Audio Software & Computer Products
Applied Acoustics Systems	ILIO	Music & Audio Software & Computer Products
Arobas	Music Marketing	Music & Audio Software & Computer Products
Audio Modeling	ILIO	Music & Audio Software & Computer Products
AVID	Music Marketing	Music & Audio Software & Computer Products
Baby Audio	Music Marketing	Music & Audio Software & Computer Products
Beyron Audio	Music Marketing	Music & Audio Software & Computer Products
Blue Cat Audio	Music Marketing	Music & Audio Software & Computer Products
BOOM Library	Music Marketing	Music & Audio Software & Computer Products
Boz Digital Labs	Music Marketing	Music & Audio Software & Computer Products
CEDAR Audio	YSL Pro	Music & Audio Software & Computer Products
Celemony	Music Marketing	Music & Audio Software & Computer Products
D16 Group	Music Marketing	Music & Audio Software & Computer Products
Delta Sound Labs	ILIO	Music & Audio Software & Computer Products
Evabeat	Music Marketing	Music & Audio Software & Computer Products
FabFilter	Music Marketing	Music & Audio Software & Computer Products
FL Studio	Music Marketing	Music & Audio Software & Computer Products
FLUX:: Immersive	LS Media	Music & Audio Software & Computer Products
Hornberg Research	ILIO	Music & Audio Software & Computer Products
iConnectivity	Hal Leonard	Music & Audio Software & Computer Products
ILIO	ILIO	Music & Audio Software & Computer Products
Image-Line	Music Marketing	Music & Audio Software & Computer Products
Indigisounds	Music Marketing	Music & Audio Software & Computer Products
Inspired Acoustics	Music Marketing	Music & Audio Software & Computer Products
Internet Co.	Music Marketing	Music & Audio Software & Computer Products
JackTrip	Hal Leonard	Music & Audio Software & Computer Products
Kilohearts	Music Marketing	Music & Audio Software & Computer Products
KResearch	Music Marketing	Music & Audio Software & Computer Products
Kuassa	Music Marketing	Music & Audio Software & Computer Products
Liquid Music	WaveDNA	Music & Audio Software & Computer Products
Liquid Rhythm	WaveDNA	Music & Audio Software & Computer Products
MAGIX	Music Marketing	Music & Audio Software & Computer Products
MeldaProduction	"Music Marketing

"	Music & Audio Software & Computer Products
Melodyne	Music Marketing	Music & Audio Software & Computer Products
MusicLab	Music Marketing	Music & Audio Software & Computer Products
My Music Staff	My Music Staff 	Music & Audio Software & Computer Products
n-Track	Music Marketing	Music & Audio Software & Computer Products
Native Instruments	Native Instruments	Music & Audio Software & Computer Products
NUGEN Audio	Music Marketing	Music & Audio Software & Computer Products
Ohm Force	Music Marketing	Music & Audio Software & Computer Products
Overloud	ILIO	Music & Audio Software & Computer Products
Pianoteq	Music Marketing	Music & Audio Software & Computer Products
PlugIn Guru	ILIO	Music & Audio Software & Computer Products
Polyverse	Music Marketing	Music & Audio Software & Computer Products
PSP Audio	Music Marketing	Music & Audio Software & Computer Products
Reason Studios	Hal Leonard	Music & Audio Software & Computer Products
Relab	Music Marketing	Music & Audio Software & Computer Products
Reveal Sound	Music Marketing	Music & Audio Software & Computer Products
Serato	SFM	Music & Audio Software & Computer Products
Slate Digital	Music Marketing	Music & Audio Software & Computer Products
Softube	YSL Pro	Music & Audio Software & Computer Products
Sonible	Music Marketing	Music & Audio Software & Computer Products
Sonnus	Hal Leonard	Music & Audio Software & Computer Products
Sonoma Wire Works	ILIO	Music & Audio Software & Computer Products
Sonuscore	Music Marketing	Music & Audio Software & Computer Products
SoundSwitch	inMusic	Music & Audio Software & Computer Products
Spectrasonics	ILIO	Music & Audio Software & Computer Products
Steven Slate Drums	Music Marketing	Music & Audio Software & Computer Products
Sugar Bytes	Music Marketing	Music & Audio Software & Computer Products
Synchro Arts	Music Marketing	Music & Audio Software & Computer Products
Synthogy	ILIO	Music & Audio Software & Computer Products
Tal Software	Music Marketing	Music & Audio Software & Computer Products
Tek'it Audio	Music Marketing	Music & Audio Software & Computer Products
The Vienna Symphonic Library u-He Software	Music Marketing	Music & Audio Software & Computer Products
Utelogy	Techni+Contact	Music & Audio Software & Computer Products
Wave Arts	Music Marketing	Music & Audio Software & Computer Products
WaveDNA	Music Marketing	Music & Audio Software & Computer Products
Waves	"GerrAudio, Waves"	Music & Audio Software & Computer Products
XCHANGE HD	Music Marketing	Music & Audio Software & Computer Products
XCHANGEMarket.com	Music Marketing	Music & Audio Software & Computer Products
Xhun Audio	Music Marketing	Music & Audio Software & Computer Products
XILS Labs	Music Marketing	Music & Audio Software & Computer Products
Admark Pro Audio	Supreme Media	"Sound Reinforcement, Installed AV & Related Products"
AMX/SVSi	Techni+Contact	"Sound Reinforcement, Installed AV & Related Products"
APB Dynasonics	Contact Distribution	"Sound Reinforcement, Installed AV & Related Products"
Aphex	Erikson Pro	"Sound Reinforcement, Installed AV & Related Products"
Appsys Pro Audio	GerrAudio	"Sound Reinforcement, Installed AV & Related Products"
Arrow	Doyle Audio	"Sound Reinforcement, Installed AV & Related Products"
ARTcessories	Yorkville Sound	"Sound Reinforcement, Installed AV & Related Products"
ARX Systems of Australia	Olsen Audio	"Sound Reinforcement, Installed AV & Related Products"
Ashly Audio	Erikson Audio	"Sound Reinforcement, Installed AV & Related Products"
AtlasIED	SC Media	"Sound Reinforcement, Installed AV & Related Products"
AudioPressBox	GerrAudio	"Sound Reinforcement, Installed AV & Related Products"
AuviTran	Contact Distribution	"Sound Reinforcement, Installed AV & Related Products"
AVANTE	SFM	"Sound Reinforcement, Installed AV & Related Products"
AVM	Audio Video Metals	"Sound Reinforcement, Installed AV & Related Products"
Axiom	Proel	"Sound Reinforcement, Installed AV & Related Products"
Axys	HPC	"Sound Reinforcement, Installed AV & Related Products"
B&C Speakers	"McBride, Q-Components"	"Sound Reinforcement, Installed AV & Related Products"
Bag End	Bag End	"Sound Reinforcement, Installed AV & Related Products"
Behringer	AVL Media	"Sound Reinforcement, Installed AV & Related Products"
Beyma	"McBride, Q-Components"	"Sound Reinforcement, Installed AV & Related Products"
Broaman	Contact Distribution	"Sound Reinforcement, Installed AV & Related Products"
BSS	HPC	"Sound Reinforcement, Installed AV & Related Products"
CODA Audio	SC Media	"Sound Reinforcement, Installed AV & Related Products"
ConferX	SFM	"Sound Reinforcement, Installed AV & Related Products"
Crest Audio by Peavey Commercial Audio	Techni+Contact	"Sound Reinforcement, Installed AV & Related Products"
Crown	HPC	"Sound Reinforcement, Installed AV & Related Products"
CTS	"McBride, Q-Components"	"Sound Reinforcement, Installed AV & Related Products"
DAS Audio	Supreme Media	"Sound Reinforcement, Installed AV & Related Products"
dB Technologies	Erikson Pro	"Sound Reinforcement, Installed AV & Related Products"
DBX	HPC	"Sound Reinforcement, Installed AV & Related Products"
Denon Professional	inMusic	"Sound Reinforcement, Installed AV & Related Products"
DiGiCo	GerrAudio	"Sound Reinforcement, Installed AV & Related Products"
DirectOut	Contact Distribution	"Sound Reinforcement, Installed AV & Related Products"
Doyle Audio Engineering.	Doyle Audio	"Sound Reinforcement, Installed AV & Related Products"
Duratex	"McBride, Q-Components"	"Sound Reinforcement, Installed AV & Related Products"
EAW	SFM	"Sound Reinforcement, Installed AV & Related Products"
ECLER	Techni+Contact	"Sound Reinforcement, Installed AV & Related Products"
EM Acoustics	Contact Distribution	"Sound Reinforcement, Installed AV & Related Products"
FBT	Erikson Audio	"Sound Reinforcement, Installed AV & Related Products"
Ferrofish	GerrAudio	"Sound Reinforcement, Installed AV & Related Products"
Fourjay	"McBride, Q-Components"	"Sound Reinforcement, Installed AV & Related Products"
Fulcrum	SFM	"Sound Reinforcement, Installed AV & Related Products"
Funktion-One	Audio Distributors International	"Sound Reinforcement, Installed AV & Related Products"
Glensound	GerrAudio	"Sound Reinforcement, Installed AV & Related Products"
Goldwood	"McBride, Q-Components"	"Sound Reinforcement, Installed AV & Related Products"
HarrisTech	"McBride, Q-Components"	"Sound Reinforcement, Installed AV & Related Products"
HK Audio	Yorkville Sound	"Sound Reinforcement, Installed AV & Related Products"
Innovox Audio	Contact Distribution	"Sound Reinforcement, Installed AV & Related Products"
JBL	HPC	"Sound Reinforcement, Installed AV & Related Products"
Klark-Teknik	AVL Media	"Sound Reinforcement, Installed AV & Related Products"
Kling & Freitag	AVL Media	"Sound Reinforcement, Installed AV & Related Products"
Lab.Gruppen	AVL Media	"Sound Reinforcement, Installed AV & Related Products"
Lake	AVL Media	"Sound Reinforcement, Installed AV & Related Products"
LEA Professional	SC Media	"Sound Reinforcement, Installed AV & Related Products"
Lencore	Contact Distribution	"Sound Reinforcement, Installed AV & Related Products"
Lexicon	HPC	"Sound Reinforcement, Installed AV & Related Products"
Linea Research	Contact Distribution	"Sound Reinforcement, Installed AV & Related Products"
LynTec	GerrAudio	"Sound Reinforcement, Installed AV & Related Products"
Make Pro Audio	Contact Distribution	"Sound Reinforcement, Installed AV & Related Products"
Marantz Professional	inMusic	"Sound Reinforcement, Installed AV & Related Products"
McBride	"McBride, Q-Components"	"Sound Reinforcement, Installed AV & Related Products"
"MediaMatrix by Peavey Commercial Audio
"	Techni+Contact	"Sound Reinforcement, Installed AV & Related Products"
Mercury Notifications	Contact Distribution	"Sound Reinforcement, Installed AV & Related Products"
Meyer Sound	GerrAudio	"Sound Reinforcement, Installed AV & Related Products"
MG Electronics	"McBride, Q-Components"	"Sound Reinforcement, Installed AV & Related Products"
Midas	AVL Media	"Sound Reinforcement, Installed AV & Related Products"
MIPRO	Techni+Contact	"Sound Reinforcement, Installed AV & Related Products"
Misco	"McBride, Q-Components"	"Sound Reinforcement, Installed AV & Related Products"
MyMix	GerrAudio	"Sound Reinforcement, Installed AV & Related Products"
NEXO	Yamaha Corp.	"Sound Reinforcement, Installed AV & Related Products"
Optocore	Contact Distribution	"Sound Reinforcement, Installed AV & Related Products"
Ortronics	Legrand	"Sound Reinforcement, Installed AV & Related Products"
OWI	Contact Distribution	"Sound Reinforcement, Installed AV & Related Products"
Panamax	SFM	"Sound Reinforcement, Installed AV & Related Products"
Patton Electronics	Techni+Contact	"Sound Reinforcement, Installed AV & Related Products"
Philips	"McBride, Q-Components"	"Sound Reinforcement, Installed AV & Related Products"
Powersoft	Erikson Audio	"Sound Reinforcement, Installed AV & Related Products"
Powerwerks	Coast Music	"Sound Reinforcement, Installed AV & Related Products"
Prologue	Techni+Contact	"Sound Reinforcement, Installed AV & Related Products"
QSC	SFM	"Sound Reinforcement, Installed AV & Related Products"
QSYS	SFM	"Sound Reinforcement, Installed AV & Related Products"
Quad Industrial	Erikson Audio	"Sound Reinforcement, Installed AV & Related Products"
Quam	"McBride, Q-Components"	"Sound Reinforcement, Installed AV & Related Products"
Radian	"McBride, Q-Components"	"Sound Reinforcement, Installed AV & Related Products"
Rane Commericial	inMusic	"Sound Reinforcement, Installed AV & Related Products"
RCF	AVL Media	"Sound Reinforcement, Installed AV & Related Products"
Renkus-Heinz	Contact Distribution	"Sound Reinforcement, Installed AV & Related Products"
RF Venue	"Audio-Technica Canada, Erikson Audio"	"Sound Reinforcement, Installed AV & Related Products"
RME	GerrAudio	"Sound Reinforcement, Installed AV & Related Products"
RTI	SFM	"Sound Reinforcement, Installed AV & Related Products"
Sammi	"McBride, Q-Components"	"Sound Reinforcement, Installed AV & Related Products"
Sonance	SC Media	"Sound Reinforcement, Installed AV & Related Products"
Soundcraft	HPC	"Sound Reinforcement, Installed AV & Related Products"
SoundScape	"McBride, Q-Components"	"Sound Reinforcement, Installed AV & Related Products"
Stewart Audio	Techni+Contact	"Sound Reinforcement, Installed AV & Related Products"
Symetrix	AVL Media	"Sound Reinforcement, Installed AV & Related Products"
Tannoy	AVL Media	"Sound Reinforcement, Installed AV & Related Products"
Timax by Outboard Electronics	Contact Distribution	"Sound Reinforcement, Installed AV & Related Products"
VERO by Funktion-One	Audio Distributors International	"Sound Reinforcement, Installed AV & Related Products"
VTC ProAudio	Yorkville Sound	"Sound Reinforcement, Installed AV & Related Products"
Waves Systems	Contact Distribution	"Sound Reinforcement, Installed AV & Related Products"
Wireless Solutions	SFM	"Sound Reinforcement, Installed AV & Related Products"
XTA Electronics	Supreme Media	"Sound Reinforcement, Installed AV & Related Products"
Yamaha Commercial Audio	Yamaha Corp.	"Sound Reinforcement, Installed AV & Related Products"
Alpine	Korg Canada	"Headphones, Hearing Protection, IEMs & Accessories"
ASI Audio/Sensaphonics	GerrAudio	"Headphones, Hearing Protection, IEMs & Accessories"
Earasers	Big Bang	"Headphones, Hearing Protection, IEMs & Accessories"
Hear Technologies	Diffusion Audio	"Headphones, Hearing Protection, IEMs & Accessories"
KLANG	GerrAudio	"Headphones, Hearing Protection, IEMs & Accessories"
Minuendo	Minuendo	"Headphones, Hearing Protection, IEMs & Accessories"
Periodic Audio	"McBride, Q-Components"	"Headphones, Hearing Protection, IEMs & Accessories"
V-Moda	Roland Canada	"Headphones, Hearing Protection, IEMs & Accessories"
Vibes	"Big Bang, Counterpoint"	"Headphones, Hearing Protection, IEMs & Accessories"
Gemini Sound Products	Coast Music	Home AV & Related Products
LoupeDesk	Audio Distributors International	Home AV & Related Products
Moukey	Donner	Home AV & Related Products
Nuvo	Legrand	Home AV & Related Products
On-Q	Legrand	Home AV & Related Products
Pro Control	SFM	
Wiremold	Legrand	Home AV & Related Products
Brahler	SFM	Intercom Systems
Clear-Com	GerrAudio	Intercom Systems
Green Go	Erikson Pro	Intercom Systems
ION Audio	inMusic	Intercom Systems
Pliant Technologies	AVL Media	Intercom Systems
Pro Intercom	Contact Distribution	Intercom Systems
Telex RTS	SFM	Intercom Systems
Telos Infinity	AVL Media	Intercom Systems
Wisycom	AVL Media	Intercom Systems
WolfVision	Techni+Contact	Intercom Systems
Zero-Ohm	AVL Media	Intercom Systems
Allen & Heath	Erikson Pro	DJ Equipment
Reloop	Erikson Audio	DJ Equipment
Denon DJ	inMusic	DJ Equipment
Gemini Sound Products	Coast Music	DJ Equipment
Mixars	Erikson Pro	DJ Equipment
MWM	SFM	DJ Equipment
Pioneer DJ	SFM	DJ Equipment
Rane DJ	inMusic	DJ Equipment
Stanton	inMusic	DJ Equipment
Audio Precision	GerrAudio	"Acoustical Products, Instrumentation & Test Equipment"
Auralex Acoustics	Auralex Acoustics	"Acoustical Products, Instrumentation & Test Equipment"
ClearSonic	ClearSonic	"Acoustical Products, Instrumentation & Test Equipment"
GeerFab Acoustics	Hal Leonard	"Acoustical Products, Instrumentation & Test Equipment"
GRAS Sound & Vibration	GerrAudio	"Acoustical Products, Instrumentation & Test Equipment"
Mellotone	"McBride, Q-Components"	"Acoustical Products, Instrumentation & Test Equipment"
Murideo	SFM	"Acoustical Products, Instrumentation & Test Equipment"
Primacoustic	"Primacoustic, Radial"	"Acoustical Products, Instrumentation & Test Equipment"
Rational Acoustics	GerrAudio	"Acoustical Products, Instrumentation & Test Equipment"
Vicoustic	Focal Naim	"Acoustical Products, Instrumentation & Test Equipment"
Absen	SC Media	"Lighting, Video & Special Effects Products"
Antari	SFM	"Lighting, Video & Special Effects Products"
ArKaos	inMusic	"Lighting, Video & Special Effects Products"
Atomos	Audio Distributors International	"Lighting, Video & Special Effects Products"
Avolites	AVL Media	"Lighting, Video & Special Effects Products"
Barco	SC Media	"Lighting, Video & Special Effects Products"
Blackmagic Design	SFM	"Lighting, Video & Special Effects Products"
Blizzard	AVL Media	"Lighting, Video & Special Effects Products"
Cameo Lighting	Adam Hall	"Lighting, Video & Special Effects Products"
Chamsys	Erikson Pro	"Lighting, Video & Special Effects Products"
Chauvet	Erikson Pro	"Lighting, Video & Special Effects Products"
Christie	SFM	"Lighting, Video & Special Effects Products"
Claypaky	SC Media	"Lighting, Video & Special Effects Products"
Da-Lite	Legrand	"Lighting, Video & Special Effects Products"
dLux	Supreme Media	"Lighting, Video & Special Effects Products"
ELC	Erikson Pro	"Lighting, Video & Special Effects Products"
Eliminator Lighting	SFM	"Lighting, Video & Special Effects Products"
Fujinon	SFM	"Lighting, Video & Special Effects Products"
GLP	AVL Media	"Lighting, Video & Special Effects Products"
Grandview	Techni+Contact	"Lighting, Video & Special Effects Products"
GTEK LED Displays	Supreme Media	"Lighting, Video & Special Effects Products"
Iluminarc	Erikson Pro	"Lighting, Video & Special Effects Products"
Infiled	AVL Media	"Lighting, Video & Special Effects Products"
Just Add Power	SFM	"Lighting, Video & Special Effects Products"
KAM	JHS	"Lighting, Video & Special Effects Products"
Littlite	SFM	"Lighting, Video & Special Effects Products"
Luxul	SFM	"Lighting, Video & Special Effects Products"
Martin Professional	HPC	"Lighting, Video & Special Effects Products"
Minrray	Techni+Contact	"Lighting, Video & Special Effects Products"
Netgear	SFM	"Lighting, Video & Special Effects Products"
Novastar	SC Media	"Lighting, Video & Special Effects Products"
Orion	Yorkville Sound	"Lighting, Video & Special Effects Products"
Spinetix	Techni+Contact	"Lighting, Video & Special Effects Products"
Spotlight	AVL Media	"Lighting, Video & Special Effects Products"
Sundrax	AVL Media	"Lighting, Video & Special Effects Products"
The Screen Works	SC Media	"Lighting, Video & Special Effects Products"
Vaddio	Legrand	"Lighting, Video & Special Effects Products"
VISS Display	SC Media	"Lighting, Video & Special Effects Products"
WORK	AVL Media	"Lighting, Video & Special Effects Products"
Xilica	Techni+Contact	"Lighting, Video & Special Effects Products"
YoloLiv	Audio Distributors International	"Lighting, Video & Special Effects Products"
ZOOM	AVL Media	"Lighting, Video & Special Effects Products"
DH Pro Stage	Proel	Staging
Global Truss	SFM	Staging
Intellistage	AVL Media	Staging
Saf-T-Rig	Erikson Pro	Staging
Trusst	Erikson Pro	Staging
33 1/3	Login Canada	"Print Music, Educational & Instructional Products"
ADG Productions	"printed music, recordings"	"Print Music, Educational & Instructional Products"
Advance Music	Jamey Aebersold Jazz	"Print Music, Educational & Instructional Products"
Alfred Publishing	"Alfred Music, Jamey Aebersold Jazz, Login Canada, Musiconeselect, NWC"	"Print Music, Educational & Instructional Products"
All for Strings	Neil A Kjos	"Print Music, Educational & Instructional Products"
AMA Verlag	Mel Bay	"Print Music, Educational & Instructional Products"
Angel	Coast Music	"Print Music, Educational & Instructional Products"
Archives	D'Addario Canada	"Print Music, Educational & Instructional Products"
Backbeat Books	Hal Leonard	"Print Music, Educational & Instructional Products"
Bass Logic	Bill Edwards	"Print Music, Educational & Instructional Products"
Bastien New Traditions All in One Piano Course	Neil A Kjos	"Print Music, Educational & Instructional Products"
Bastien Piano Basics	Neil A Kjos	"Print Music, Educational & Instructional Products"
Beacon Music Company - Dick Bennett Guitar	Musiconeselect	"Print Music, Educational & Instructional Products"
Belwin	Alfred Music	"Print Music, Educational & Instructional Products"
Berandol Music	Mayfair	"Print Music, Educational & Instructional Products"
Berklee Press	"Hal Leonard, Jamey Aebersold Jazz"	"Print Music, Educational & Instructional Products"
Bernard Stein Music Company	Musiconeselect	"Print Music, Educational & Instructional Products"
Black Ink	NWC	"Print Music, Educational & Instructional Products"
Bloomsbury Academic	Login Canada	"Print Music, Educational & Instructional Products"
Blue Rodeo Songbooks	Musiconeselect	"Print Music, Educational & Instructional Products"
Breezin' Thru	Breezin' Thru	"Print Music, Educational & Instructional Products"
BriLee Music	Carl Fischer	"Print Music, Educational & Instructional Products"
Broadway Press	NWC	"Print Music, Educational & Instructional Products"
Broude Bros and Broude Trust	Alfred Music	"Print Music, Educational & Instructional Products"
Canadian Music Trade Magazine	NWC	"Print Music, Educational & Instructional Products"
Canadian Musician Magazine	NWC	"Print Music, Educational & Instructional Products"
Carl Fischer	"Carl Fischer, Musiconeselect, NWC"	"Print Music, Educational & Instructional Products"
Cengage	NWC	"Print Music, Educational & Instructional Products"
Centerstream Publishing	Hal Leonard	"Print Music, Educational & Instructional Products"
Charles Colin Publications	"Charles Colin, Jamey Aebersold Jazz"	"Print Music, Educational & Instructional Products"
Conservatory Canada	"Music for Young
Children"	"Print Music, Educational & Instructional Products"
Dancing Hands Music	Mel Bay	"Print Music, Educational & Instructional Products"
David E. Smith Publications	David E. Smith	"Print Music, Educational & Instructional Products"
Debra Wanless [Christopher Norton Connections Lawless Theory]	Musiconeselect	"Print Music, Educational & Instructional Products"
DEG	St. Louis Music	"Print Music, Educational & Instructional Products"
Doctor Mozart	April Avenue	"Print Music, Educational & Instructional Products"
Doug Beach Music	Excelcia	"Print Music, Educational & Instructional Products"
Dover Publications	Alfred Music	"Print Music, Educational & Instructional Products"
Edition Bourges -Chilly Gonzales	Musiconeselect	"Print Music, Educational & Instructional Products"
Edition Peters	"Alfred Music, Musiconeselect"	"Print Music, Educational & Instructional Products"
Edition Royalto	Alfred Music	"Print Music, Educational & Instructional Products"
Edwin F. Kalmus	Alfred Music	"Print Music, Educational & Instructional Products"
Essential Elements	Hal Leonard	"Print Music, Educational & Instructional Products"
ETP	NWC	"Print Music, Educational & Instructional Products"
Excelcia	Excelcia	"Print Music, Educational & Instructional Products"
Excellence in Theory	Neil A Kjos	"Print Music, Educational & Instructional Products"
Faber Music	Alfred Music	"Print Music, Educational & Instructional Products"
Faber Piano Adventures	Hal Leonard	"Print Music, Educational & Instructional Products"
FJH	Musiconeselect	"Print Music, Educational & Instructional Products"
Focal Press	NWC	"Print Music, Educational & Instructional Products"
Foundations for Superior Performance	Neil A Kjos	"Print Music, Educational & Instructional Products"
Frederick Harris	"Musiconeselect, Music for Young Children, NWC, RCM Publishing"	"Print Music, Educational & Instructional Products"
Fretboard Logic	Bill Edwards	"Print Music, Educational & Instructional Products"
GIA	Musiconeselect	"Print Music, Educational & Instructional Products"
Gia Publications	Jamey Aebersold Jazz	"Print Music, Educational & Instructional Products"
Groove3	Hal Leonard	"Print Music, Educational & Instructional Products"
Grossman's Guitar Workshop	Mel Bay	"Print Music, Educational & Instructional Products"
Guitar Master Class Publications	Mel Bay	"Print Music, Educational & Instructional Products"
Hal Leonard	"Hal Leonard, Jamey Aebersold Jazz, Login Canada, Musiconeselect, NWC"	"Print Music, Educational & Instructional Products"
Highland/Etling	Alfred Music	"Print Music, Educational & Instructional Products"
Homespun	Hal Leonard	"Print Music, Educational & Instructional Products"
Hope	Musiconeselect	"Print Music, Educational & Instructional Products"
Hudson Music	Hal Leonard	"Print Music, Educational & Instructional Products"
International Music Company	"Musicone-
select"	"Print Music, Educational & Instructional Products"
JAL Press	Mayfair	"Print Music, Educational & Instructional Products"
Jamey Aebersold Jazz	"Alfred Music, Jamey Aebersold Jazz, Musiconeselect"	"Print Music, Educational & Instructional Products"
Joel Rothman Publications	Musiconeselect	"Print Music, Educational & Instructional Products"
Kalmus	Alfred Music	"Print Music, Educational & Instructional Products"
Ken Bauer Productions	David E. Smith	"Print Music, Educational & Instructional Products"
Kendor Music	"Excelcia, Jamey Aebersold Jazz"	"Print Music, Educational & Instructional Products"
Kjos	Musiconeselect	"Print Music, Educational & Instructional Products"
KJOS	NWC	"Print Music, Educational & Instructional Products"
Koala Music/Learn to Play Music	"Musicone-
select"	"Print Music, Educational & Instructional Products"
Leila Fletcher	Mayfair	"Print Music, Educational & Instructional Products"
Leslie Music Supply	Mayfair	"Print Music, Educational & Instructional Products"
Light of the World Music	David E. Smith	"Print Music, Educational & Instructional Products"
Lorenz	Musiconeselect	"Print Music, Educational & Instructional Products"
LudwigMasters Publications	Alfred Music	"Print Music, Educational & Instructional Products"
Majestic Music Publications	David E. Smith	"Print Music, Educational & Instructional Products"
Marlo Folders	Hal Leonard	"Print Music, Educational & Instructional Products"
Mayfair Music Publications	"Mayfair,
Musiconeselect"	"Print Music, Educational & Instructional Products"
McGinnis and Marx	Alfred Music	"Print Music, Educational & Instructional Products"
McGraw-Hill	NWC	"Print Music, Educational & Instructional Products"
Mel Bay	"Jamey Aebersold Jazz, Login Canada, Mel Bay, Musiconeselect, NWC"	"Print Music, Educational & Instructional Products"
MJS	NWC	"Print Music, Educational & Instructional Products"
Music for Young Children	Music for Young Children	"Print Music, Educational & Instructional Products"
Music Sales	Jamey Aebersold Jazz	"Print Music, Educational & Instructional Products"
Musica Baltica	Alfred Music	"Print Music, Educational & Instructional Products"
MUSICFOLDER.com	Small World	"Print Music, Educational & Instructional Products"
Musicians Institute	Hal Leonard	"Print Music, Educational & Instructional Products"
Native Ground Music Inc.	Mel Bay	"Print Music, Educational & Instructional Products"
Note Speed Card	Musiconeselect	"Print Music, Educational & Instructional Products"
NoteFlight	Hal Leonard	"Print Music, Educational & Instructional Products"
Nuvo Instrumental	Counterpoint	"Print Music, Educational & Instructional Products"
One Eye Publications Oxford University Press	Musiconeselect	"Print Music, Educational & Instructional Products"
Penguin	Alfred Music	"Print Music, Educational & Instructional Products"
PIANO Plus!	Gilpin Publishing	"Print Music, Educational & Instructional Products"
Piano Pronto	Musiconeselect	"Print Music, Educational & Instructional Products"
Piano Town	Neil A Kjos	"Print Music, Educational & Instructional Products"
Prentice Hall	Jamey Aebersold Jazz	"Print Music, Educational & Instructional Products"
"Professional Lighting & Production Magazine
"	NWC	"Print Music, Educational & Instructional Products"
Professional Sound Magazine	NWC	"Print Music, Educational & Instructional Products"
Psalm 150 Publications	David E. Smith	"Print Music, Educational & Instructional Products"
RCM Publishing	RCM Publishing	"Print Music, Educational & Instructional Products"
Reditmo	Donner	"Print Music, Educational & Instructional Products"
Rich Heffler Music	David E. Smith	"Print Music, Educational & Instructional Products"
Rick Latham	Alfred Music	"Print Music, Educational & Instructional Products"
River Song Productions	David E. Smith	"Print Music, Educational & Instructional Products"
Routledge	Login Canada	"Print Music, Educational & Instructional Products"
Royal Conservatory of Music	Music for Young Children	"Print Music, Educational & Instructional Products"
Sammy Nestico Music	Excelcia	"Print Music, Educational & Instructional Products"
Santorella	"Musiconeselect, NWC"	"Print Music, Educational & Instructional Products"
Shawnee Press	Hal Leonard	"Print Music, Educational & Instructional Products"
Sher Music	"Jamey Aebersold Jazz, Musiconeselect, Sher Music"	"Print Music, Educational & Instructional Products"
Sight Singing for Success	Musiconeselect	"Print Music, Educational & Instructional Products"
Simon & Schuster	Jamey Aebersold Jazz	"Print Music, Educational & Instructional Products"
Skeptical Guitarist	Musiconeselect	"Print Music, Educational & Instructional Products"
Standard of Excellence	Neil A Kjos	"Print Music, Educational & Instructional Products"
Stipes	Musiconeselect	"Print Music, Educational & Instructional Products"
Stockton Music Services	David E. Smith	"Print Music, Educational & Instructional Products"
String Basics	Neil A Kjos	"Print Music, Educational & Instructional Products"
The Full Voice	Musiconeselect	"Print Music, Educational & Instructional Products"
Theory Time	Musiconeselect	"Print Music, Educational & Instructional Products"
Tradition of Excellence	Neil A Kjos	"Print Music, Educational & Instructional Products"
Ultimate Music Theory	"Ultimate Music
Theory"	"Print Music, Educational & Instructional Products"
Vintage Guitar Price Guides	Hal Leonard	"Print Music, Educational & Instructional Products"
Watch & Learn	Musiconeselect	"Print Music, Educational & Instructional Products"
Watch Me Play	Bill Edwards	"Print Music, Educational & Instructional Products"
Waterloo Publications	Mayfair	"Print Music, Educational & Instructional Products"
Wiley	John Wiley	"Print Music, Educational & Instructional Products"
Willis Music	Willis Music	"Print Music, Educational & Instructional Products"
Willis Piano	Hal Leonard	"Print Music, Educational & Instructional Products"
Windsongs Recorder Method	Empire Music	"Print Music, Educational & Instructional Products"
Active-e	Tri-Technical	"Gifts & Toys, Retail Displays & Solutions, Miscellaneous"
Aim Gifts	Counterpoint	"Gifts & Toys, Retail Displays & Solutions, Miscellaneous"
AIMsi	Tri-Technical	"Gifts & Toys, Retail Displays & Solutions, Miscellaneous"
Axe Heaven	Hal Leonard	"Gifts & Toys, Retail Displays & Solutions, Miscellaneous"
Dynatomy by D'Addario	D'Addario Canada	"Gifts & Toys, Retail Displays & Solutions, Miscellaneous"
Future Primitive	Chesbro Music	"Gifts & Toys, Retail Displays & Solutions, Miscellaneous"
Gig Gear	Gig Gear	"Gifts & Toys, Retail Displays & Solutions, Miscellaneous"
HAS	HSA	"Gifts & Toys, Retail Displays & Solutions, Miscellaneous"
Inovativ	SFM	"Gifts & Toys, Retail Displays & Solutions, Miscellaneous"
iPort	SC Media	"Gifts & Toys, Retail Displays & Solutions, Miscellaneous"
Lizard Spit	Golden Hawk	"Gifts & Toys, Retail Displays & Solutions, Miscellaneous"
Mayfair Gifts	Mayfair	"Gifts & Toys, Retail Displays & Solutions, Miscellaneous"
MG Chemicals	Next Gen Musical	"Gifts & Toys, Retail Displays & Solutions, Miscellaneous"
Music Stamps	D'Addario Canada	"Gifts & Toys, Retail Displays & Solutions, Miscellaneous"
MusicNomad	SFM	"Gifts & Toys, Retail Displays & Solutions, Miscellaneous"
Oasis	Coast Music	"Gifts & Toys, Retail Displays & Solutions, Miscellaneous"
Rain Retail	Rain Retail	"Gifts & Toys, Retail Displays & Solutions, Miscellaneous"
Trophy	Coast Music	"Gifts & Toys, Retail Displays & Solutions, Miscellaneous"
Woodrow	Hal Leonard	"Gifts & Toys, Retail Displays & Solutions, Miscellaneous"